Id2,Geography,Estimate; Total:,Margin of Error; Total:,Estimate; Owner occupied,Margin of Error; Owner occupied,Estimate; Renter occupied,Margin of Error; Renter occupied
6001400100,"Census Tract 4001, Alameda County, California",1308,108,1171,107,137,74
6001400200,"Census Tract 4002, Alameda County, California",902,42,593,71,309,73
6001400300,"Census Tract 4003, Alameda County, California",2626,132,1064,150,1562,182
6001400400,"Census Tract 4004, Alameda County, California",1964,87,852,133,1112,152
6001400500,"Census Tract 4005, Alameda County, California",1686,82,738,102,948,119
6001400600,"Census Tract 4006, Alameda County, California",701,71,330,76,371,101
6001400700,"Census Tract 4007, Alameda County, California",1672,153,661,116,1011,166
6001400800,"Census Tract 4008, Alameda County, California",1433,104,427,90,1006,119
6001400900,"Census Tract 4009, Alameda County, California",1095,87,480,89,615,110
6001401000,"Census Tract 4010, Alameda County, California",2168,224,918,185,1250,256
6001401100,"Census Tract 4011, Alameda County, California",2076,140,397,104,1679,159
6001401200,"Census Tract 4012, Alameda County, California",1352,84,632,134,720,142
6001401300,"Census Tract 4013, Alameda County, California",1434,127,199,70,1235,137
6001401400,"Census Tract 4014, Alameda County, California",1469,137,278,105,1191,160
6001401500,"Census Tract 4015, Alameda County, California",961,123,386,111,575,130
6001401600,"Census Tract 4016, Alameda County, California",717,107,104,64,613,110
6001401700,"Census Tract 4017, Alameda County, California",637,109,374,112,263,88
6001401800,"Census Tract 4018, Alameda County, California",482,111,99,57,383,113
6001401900,"Census Tract 4019, Alameda County, California",256,112,82,48,174,110
6001402000,"Census Tract 4020, Alameda County, California",31,29,10,16,21,33
6001402100,"Census Tract 4021, Alameda County, California",802,91,35,37,767,88
6001402200,"Census Tract 4022, Alameda County, California",655,85,155,71,500,106
6001402300,"Census Tract 4023, Alameda County, California",146,78,20,23,126,77
6001402400,"Census Tract 4024, Alameda County, California",1032,111,282,103,750,113
6001402500,"Census Tract 4025, Alameda County, California",787,72,136,77,651,86
6001402600,"Census Tract 4026, Alameda County, California",540,72,159,68,381,78
6001402700,"Census Tract 4027, Alameda County, California",651,82,213,103,438,125
6001402800,"Census Tract 4028, Alameda County, California",1163,100,77,45,1086,107
6001402900,"Census Tract 4029, Alameda County, California",763,76,15,23,748,76
6001403000,"Census Tract 4030, Alameda County, California",1211,151,294,94,917,153
6001403100,"Census Tract 4031, Alameda County, California",500,68,204,59,296,80
6001403200,"Census Tract 4032, Alameda County, California",40,22,40,22,0,132
6001403300,"Census Tract 4033, Alameda County, California",1936,181,432,112,1504,175
6001403400,"Census Tract 4034, Alameda County, California",2960,136,433,97,2527,171
6001403500,"Census Tract 4035, Alameda County, California",3554,212,663,171,2891,234
6001403600,"Census Tract 4036, Alameda County, California",2709,143,506,167,2203,183
6001403700,"Census Tract 4037, Alameda County, California",3058,192,524,135,2534,232
6001403800,"Census Tract 4038, Alameda County, California",1997,105,670,112,1327,124
6001403900,"Census Tract 4039, Alameda County, California",2415,90,1000,150,1415,163
6001404000,"Census Tract 4040, Alameda County, California",1777,125,410,84,1367,145
6001404100,"Census Tract 4041, Alameda County, California",3600,173,888,209,2712,254
6001404200,"Census Tract 4042, Alameda County, California",1456,60,1218,79,238,72
6001404300,"Census Tract 4043, Alameda County, California",1406,61,1249,82,157,68
6001404400,"Census Tract 4044, Alameda County, California",2372,117,2005,134,367,138
6001404501,"Census Tract 4045.01, Alameda County, California",720,45,641,60,79,55
6001404502,"Census Tract 4045.02, Alameda County, California",2631,86,2249,155,382,159
6001404600,"Census Tract 4046, Alameda County, California",1880,88,1814,93,66,50
6001404700,"Census Tract 4047, Alameda County, California",849,52,737,71,112,59
6001404800,"Census Tract 4048, Alameda County, California",1384,43,747,127,637,134
6001404900,"Census Tract 4049, Alameda County, California",1989,96,1247,129,742,153
6001405000,"Census Tract 4050, Alameda County, California",1519,104,886,117,633,138
6001405100,"Census Tract 4051, Alameda County, California",1670,73,1586,76,84,67
6001405200,"Census Tract 4052, Alameda County, California",2451,171,567,138,1884,202
6001405300,"Census Tract 4053, Alameda County, California",3406,100,299,99,3107,147
6001405400,"Census Tract 4054, Alameda County, California",2682,176,340,127,2342,178
6001405500,"Census Tract 4055, Alameda County, California",1442,154,335,90,1107,173
6001405600,"Census Tract 4056, Alameda County, California",1379,100,311,90,1068,113
6001405700,"Census Tract 4057, Alameda County, California",1254,118,478,94,776,125
6001405800,"Census Tract 4058, Alameda County, California",1246,109,520,114,726,144
6001405900,"Census Tract 4059, Alameda County, California",2056,140,523,174,1533,200
6001406000,"Census Tract 4060, Alameda County, California",1401,115,189,78,1212,109
6001406100,"Census Tract 4061, Alameda County, California",1310,115,376,112,934,151
6001406201,"Census Tract 4062.01, Alameda County, California",1480,112,298,82,1182,115
6001406202,"Census Tract 4062.02, Alameda County, California",1240,101,162,61,1078,110
6001406300,"Census Tract 4063, Alameda County, California",1256,102,657,162,599,142
6001406400,"Census Tract 4064, Alameda County, California",725,66,385,68,340,91
6001406500,"Census Tract 4065, Alameda County, California",1926,126,800,138,1126,147
6001406600,"Census Tract 4066, Alameda County, California",2815,153,1178,191,1637,231
6001406700,"Census Tract 4067, Alameda County, California",2180,151,1580,177,600,167
6001406800,"Census Tract 4068, Alameda County, California",1439,92,1086,100,353,106
6001406900,"Census Tract 4069, Alameda County, California",1531,95,1010,149,521,142
6001407000,"Census Tract 4070, Alameda County, California",2129,151,714,127,1415,182
6001407100,"Census Tract 4071, Alameda County, California",2159,186,1039,140,1120,204
6001407200,"Census Tract 4072, Alameda County, California",1604,151,528,112,1076,178
6001407300,"Census Tract 4073, Alameda County, California",737,67,266,61,471,86
6001407400,"Census Tract 4074, Alameda County, California",1050,175,362,68,688,179
6001407500,"Census Tract 4075, Alameda County, California",1263,104,386,96,877,132
6001407600,"Census Tract 4076, Alameda County, California",2209,151,1063,212,1146,205
6001407700,"Census Tract 4077, Alameda County, California",1813,109,1353,144,460,138
6001407800,"Census Tract 4078, Alameda County, California",798,78,659,89,139,77
6001407900,"Census Tract 4079, Alameda County, California",1087,106,874,106,213,80
6001408000,"Census Tract 4080, Alameda County, California",984,67,864,85,120,54
6001408100,"Census Tract 4081, Alameda County, California",2418,146,1881,149,537,134
6001408200,"Census Tract 4082, Alameda County, California",1693,130,899,130,794,152
6001408300,"Census Tract 4083, Alameda County, California",1793,99,1139,114,654,143
6001408400,"Census Tract 4084, Alameda County, California",1263,109,722,138,541,141
6001408500,"Census Tract 4085, Alameda County, California",1533,130,826,144,707,157
6001408600,"Census Tract 4086, Alameda County, California",1721,106,690,150,1031,149
6001408700,"Census Tract 4087, Alameda County, California",2322,155,1104,176,1218,216
6001408800,"Census Tract 4088, Alameda County, California",1527,129,671,191,856,155
6001408900,"Census Tract 4089, Alameda County, California",949,94,343,87,606,116
6001409000,"Census Tract 4090, Alameda County, California",1026,91,583,113,443,129
6001409100,"Census Tract 4091, Alameda County, California",694,43,480,86,214,92
6001409200,"Census Tract 4092, Alameda County, California",782,77,473,92,309,98
6001409300,"Census Tract 4093, Alameda County, California",1704,98,708,156,996,144
6001409400,"Census Tract 4094, Alameda County, California",1134,98,489,97,645,143
6001409500,"Census Tract 4095, Alameda County, California",822,103,327,88,495,119
6001409600,"Census Tract 4096, Alameda County, California",1477,128,761,107,716,129
6001409700,"Census Tract 4097, Alameda County, California",1574,112,468,95,1106,136
6001409800,"Census Tract 4098, Alameda County, California",1287,76,799,88,488,96
6001409900,"Census Tract 4099, Alameda County, California",1375,91,1276,110,99,68
6001410000,"Census Tract 4100, Alameda County, California",1202,66,1078,86,124,64
6001410100,"Census Tract 4101, Alameda County, California",963,85,542,102,421,114
6001410200,"Census Tract 4102, Alameda County, California",1049,107,457,92,592,116
6001410300,"Census Tract 4103, Alameda County, California",1042,80,461,120,581,119
6001410400,"Census Tract 4104, Alameda County, California",1246,77,800,131,446,135
6001420100,"Census Tract 4201, Alameda County, California",834,44,647,69,187,59
6001420200,"Census Tract 4202, Alameda County, California",1071,97,345,68,726,112
6001420300,"Census Tract 4203, Alameda County, California",1860,89,1102,141,758,139
6001420400,"Census Tract 4204, Alameda County, California",701,93,8,12,693,92
6001420500,"Census Tract 4205, Alameda County, California",788,67,396,82,392,85
6001420600,"Census Tract 4206, Alameda County, California",1189,64,930,83,259,84
6001421100,"Census Tract 4211, Alameda County, California",736,66,699,70,37,25
6001421200,"Census Tract 4212, Alameda County, California",1287,74,1224,84,63,50
6001421300,"Census Tract 4213, Alameda County, California",1503,80,1317,89,186,63
6001421400,"Census Tract 4214, Alameda County, California",623,42,495,62,128,62
6001421500,"Census Tract 4215, Alameda County, California",1435,88,1183,111,252,100
6001421600,"Census Tract 4216, Alameda County, California",1502,78,1135,102,367,90
6001421700,"Census Tract 4217, Alameda County, California",1510,80,570,97,940,106
6001421800,"Census Tract 4218, Alameda County, California",800,70,560,85,240,69
6001421900,"Census Tract 4219, Alameda County, California",1558,82,919,89,639,89
6001422000,"Census Tract 4220, Alameda County, California",435,74,209,66,226,79
6001422100,"Census Tract 4221, Alameda County, California",844,117,408,67,436,106
6001422200,"Census Tract 4222, Alameda County, California",1473,81,654,112,819,120
6001422300,"Census Tract 4223, Alameda County, California",1413,115,603,109,810,111
6001422400,"Census Tract 4224, Alameda County, California",2001,108,254,91,1747,132
6001422500,"Census Tract 4225, Alameda County, California",1447,92,276,69,1171,110
6001422600,"Census Tract 4226, Alameda County, California",24,13,0,132,24,13
6001422700,"Census Tract 4227, Alameda County, California",916,81,163,34,753,85
6001422800,"Census Tract 4228, Alameda County, California",1208,118,7,11,1201,118
6001422900,"Census Tract 4229, Alameda County, California",1445,95,25,25,1420,98
6001423000,"Census Tract 4230, Alameda County, California",1831,136,826,110,1005,142
6001423100,"Census Tract 4231, Alameda County, California",1641,100,667,94,974,106
6001423200,"Census Tract 4232, Alameda County, California",960,88,354,65,606,96
6001423300,"Census Tract 4233, Alameda County, California",1399,105,861,107,538,105
6001423400,"Census Tract 4234, Alameda County, California",1781,140,726,145,1055,164
6001423500,"Census Tract 4235, Alameda County, California",1246,63,514,94,732,106
6001423601,"Census Tract 4236.01, Alameda County, California",1125,70,410,76,715,90
6001423602,"Census Tract 4236.02, Alameda County, California",2037,159,320,95,1717,165
6001423700,"Census Tract 4237, Alameda County, California",1110,92,409,72,701,107
6001423800,"Census Tract 4238, Alameda County, California",1228,79,957,78,271,74
6001423901,"Census Tract 4239.01, Alameda County, California",793,67,368,68,425,91
6001423902,"Census Tract 4239.02, Alameda County, California",755,35,394,99,361,97
6001424001,"Census Tract 4240.01, Alameda County, California",1242,102,229,79,1013,143
6001424002,"Census Tract 4240.02, Alameda County, California",771,69,326,74,445,84
6001425100,"Census Tract 4251, Alameda County, California",5261,339,1829,248,3432,331
6001426100,"Census Tract 4261, Alameda County, California",1922,95,1765,114,157,78
6001426200,"Census Tract 4262, Alameda County, California",1481,91,1242,95,239,90
6001427100,"Census Tract 4271, Alameda County, California",1422,45,967,124,455,128
6001427200,"Census Tract 4272, Alameda County, California",1443,98,536,96,907,130
6001427300,"Census Tract 4273, Alameda County, California",1970,102,854,145,1116,158
6001427400,"Census Tract 4274, Alameda County, California",448,83,212,74,236,73
6001427500,"Census Tract 4275, Alameda County, California",280,61,0,132,280,61
6001427600,"Census Tract 4276, Alameda County, California",1241,129,218,67,1023,127
6001427700,"Census Tract 4277, Alameda County, California",2232,129,852,115,1380,160
6001427800,"Census Tract 4278, Alameda County, California",1909,106,802,143,1107,159
6001427900,"Census Tract 4279, Alameda County, California",2094,89,816,116,1278,128
6001428000,"Census Tract 4280, Alameda County, California",1265,92,152,52,1113,99
6001428100,"Census Tract 4281, Alameda County, California",1896,121,973,120,923,135
6001428200,"Census Tract 4282, Alameda County, California",2409,168,1448,153,961,179
6001428301,"Census Tract 4283.01, Alameda County, California",2162,126,1813,131,349,108
6001428302,"Census Tract 4283.02, Alameda County, California",2441,101,2156,144,285,106
6001428400,"Census Tract 4284, Alameda County, California",1746,118,545,86,1201,148
6001428500,"Census Tract 4285, Alameda County, California",1378,65,477,70,901,91
6001428600,"Census Tract 4286, Alameda County, California",1494,71,802,109,692,111
6001430100,"Census Tract 4301, Alameda County, California",3062,103,2669,157,393,142
6001430200,"Census Tract 4302, Alameda County, California",2305,83,2126,110,179,81
6001430300,"Census Tract 4303, Alameda County, California",1261,48,1135,74,126,58
6001430400,"Census Tract 4304, Alameda County, California",747,20,723,30,24,21
6001430500,"Census Tract 4305, Alameda County, California",1978,117,1214,176,764,188
6001430600,"Census Tract 4306, Alameda County, California",2023,113,1813,153,210,95
6001430700,"Census Tract 4307, Alameda County, California",1243,91,1031,92,212,88
6001430800,"Census Tract 4308, Alameda County, California",2088,80,1583,113,505,106
6001430900,"Census Tract 4309, Alameda County, California",1795,86,249,72,1546,109
6001431000,"Census Tract 4310, Alameda County, California",1174,46,563,80,611,91
6001431100,"Census Tract 4311, Alameda County, California",1293,70,503,88,790,99
6001431200,"Census Tract 4312, Alameda County, California",2475,152,1046,196,1429,205
6001432100,"Census Tract 4321, Alameda County, California",1195,72,970,92,225,79
6001432200,"Census Tract 4322, Alameda County, California",1349,94,597,84,752,107
6001432300,"Census Tract 4323, Alameda County, California",1283,95,878,119,405,92
6001432400,"Census Tract 4324, Alameda County, California",1558,104,835,124,723,138
6001432500,"Census Tract 4325, Alameda County, California",2587,85,1598,182,989,172
6001432600,"Census Tract 4326, Alameda County, California",2669,108,764,132,1905,163
6001432700,"Census Tract 4327, Alameda County, California",961,41,712,76,249,83
6001432800,"Census Tract 4328, Alameda County, California",1293,69,1110,85,183,80
6001433000,"Census Tract 4330, Alameda County, California",1246,54,1024,94,222,89
6001433101,"Census Tract 4331.01, Alameda County, California",2809,144,762,171,2047,185
6001433102,"Census Tract 4331.02, Alameda County, California",1167,49,738,107,429,117
6001433200,"Census Tract 4332, Alameda County, California",2397,95,997,117,1400,128
6001433300,"Census Tract 4333, Alameda County, California",1908,82,1608,128,300,110
6001433400,"Census Tract 4334, Alameda County, California",1994,88,1754,135,240,102
6001433500,"Census Tract 4335, Alameda County, California",1198,67,1050,84,148,68
6001433600,"Census Tract 4336, Alameda County, California",1873,91,1046,146,827,142
6001433700,"Census Tract 4337, Alameda County, California",842,119,382,98,460,115
6001433800,"Census Tract 4338, Alameda County, California",2341,140,1113,150,1228,172
6001433900,"Census Tract 4339, Alameda County, California",1937,125,421,136,1516,156
6001434000,"Census Tract 4340, Alameda County, California",1569,84,572,123,997,145
6001435101,"Census Tract 4351.01, Alameda County, California",3714,180,2311,203,1403,219
6001435102,"Census Tract 4351.02, Alameda County, California",1694,147,1197,136,497,210
6001435200,"Census Tract 4352, Alameda County, California",1296,86,998,115,298,108
6001435300,"Census Tract 4353, Alameda County, California",1615,107,596,91,1019,143
6001435400,"Census Tract 4354, Alameda County, California",1949,134,537,97,1412,150
6001435500,"Census Tract 4355, Alameda County, California",1385,85,439,90,946,105
6001435600,"Census Tract 4356, Alameda County, California",2929,141,1064,208,1865,219
6001435700,"Census Tract 4357, Alameda County, California",1355,91,971,123,384,120
6001435800,"Census Tract 4358, Alameda County, California",1588,48,1221,120,367,125
6001435900,"Census Tract 4359, Alameda County, California",1591,58,1353,128,238,117
6001436000,"Census Tract 4360, Alameda County, California",1312,84,1077,120,235,95
6001436100,"Census Tract 4361, Alameda County, California",1683,77,899,116,784,125
6001436200,"Census Tract 4362, Alameda County, California",996,100,238,75,758,110
6001436300,"Census Tract 4363, Alameda County, California",1884,126,675,101,1209,145
6001436401,"Census Tract 4364.01, Alameda County, California",2623,149,1636,187,987,188
6001436402,"Census Tract 4364.02, Alameda County, California",990,82,935,84,55,63
6001436500,"Census Tract 4365, Alameda County, California",1673,102,422,78,1251,140
6001436601,"Census Tract 4366.01, Alameda County, California",1939,94,717,109,1222,134
6001436602,"Census Tract 4366.02, Alameda County, California",1481,110,399,98,1082,151
6001436700,"Census Tract 4367, Alameda County, California",1094,56,660,111,434,115
6001436800,"Census Tract 4368, Alameda County, California",1296,99,698,131,598,144
6001436900,"Census Tract 4369, Alameda County, California",1719,124,834,128,885,127
6001437000,"Census Tract 4370, Alameda County, California",1113,100,936,81,177,94
6001437100,"Census Tract 4371, Alameda County, California",3054,166,2352,205,702,225
6001437200,"Census Tract 4372, Alameda County, California",2052,128,1446,145,606,157
6001437300,"Census Tract 4373, Alameda County, California",804,97,542,87,262,104
6001437400,"Census Tract 4374, Alameda County, California",965,33,702,108,263,96
6001437500,"Census Tract 4375, Alameda County, California",1119,85,290,79,829,102
6001437600,"Census Tract 4376, Alameda County, California",889,61,560,101,329,102
6001437700,"Census Tract 4377, Alameda County, California",1800,162,280,124,1520,193
6001437800,"Census Tract 4378, Alameda County, California",1225,95,930,105,295,91
6001437900,"Census Tract 4379, Alameda County, California",609,105,296,65,313,105
6001438000,"Census Tract 4380, Alameda County, California",1076,69,750,92,326,88
6001438100,"Census Tract 4381, Alameda County, California",2051,103,1728,179,323,150
6001438201,"Census Tract 4382.01, Alameda County, California",1165,83,996,118,169,96
6001438202,"Census Tract 4382.02, Alameda County, California",3067,136,2666,195,401,177
6001438300,"Census Tract 4383, Alameda County, California",949,56,793,83,156,74
6001438400,"Census Tract 4384, Alameda County, California",754,19,705,49,49,47
6001440100,"Census Tract 4401, Alameda County, California",676,90,482,92,194,73
6001440200,"Census Tract 4402, Alameda County, California",1542,105,848,125,694,145
6001440301,"Census Tract 4403.01, Alameda County, California",2086,149,1646,161,440,175
6001440302,"Census Tract 4403.02, Alameda County, California",1920,120,1575,148,345,137
6001440304,"Census Tract 4403.04, Alameda County, California",1330,93,1008,102,322,86
6001440305,"Census Tract 4403.05, Alameda County, California",1060,66,854,106,206,83
6001440306,"Census Tract 4403.06, Alameda County, California",973,79,742,87,231,72
6001440307,"Census Tract 4403.07, Alameda County, California",1504,136,1270,141,234,78
6001440308,"Census Tract 4403.08, Alameda County, California",1977,142,1179,174,798,179
6001440309,"Census Tract 4403.09, Alameda County, California",3107,145,2145,172,962,153
6001440331,"Census Tract 4403.31, Alameda County, California",807,118,461,110,346,114
6001440332,"Census Tract 4403.32, Alameda County, California",913,56,863,71,50,36
6001441100,"Census Tract 4411, Alameda County, California",1462,103,1099,133,363,111
6001441200,"Census Tract 4412, Alameda County, California",2391,111,1449,153,942,156
6001441301,"Census Tract 4413.01, Alameda County, California",1036,78,539,75,497,86
6001441302,"Census Tract 4413.02, Alameda County, California",1695,98,1195,127,500,113
6001441401,"Census Tract 4414.01, Alameda County, California",2188,118,1649,155,539,158
6001441402,"Census Tract 4414.02, Alameda County, California",1516,103,1220,110,296,87
6001441501,"Census Tract 4415.01, Alameda County, California",1741,77,1556,111,185,90
6001441503,"Census Tract 4415.03, Alameda County, California",3938,125,2541,178,1397,165
6001441521,"Census Tract 4415.21, Alameda County, California",1741,55,1429,113,312,103
6001441522,"Census Tract 4415.22, Alameda County, California",1405,42,1139,93,266,93
6001441601,"Census Tract 4416.01, Alameda County, California",1347,69,1035,108,312,97
6001441602,"Census Tract 4416.02, Alameda County, California",2129,107,1216,155,913,161
6001441700,"Census Tract 4417, Alameda County, California",2237,178,1463,185,774,189
6001441800,"Census Tract 4418, Alameda County, California",2281,73,1251,154,1030,149
6001441901,"Census Tract 4419.01, Alameda County, California",4747,245,2003,241,2744,291
6001441921,"Census Tract 4419.21, Alameda County, California",1205,69,352,94,853,85
6001441922,"Census Tract 4419.22, Alameda County, California",2690,210,846,137,1844,210
6001441923,"Census Tract 4419.23, Alameda County, California",1921,135,159,65,1762,147
6001442000,"Census Tract 4420, Alameda County, California",981,28,951,41,30,27
6001442100,"Census Tract 4421, Alameda County, California",1552,57,1382,86,170,74
6001442200,"Census Tract 4422, Alameda County, California",1994,110,1685,131,309,101
6001442300,"Census Tract 4423, Alameda County, California",2882,125,1207,178,1675,181
6001442400,"Census Tract 4424, Alameda County, California",1677,94,1315,110,362,95
6001442500,"Census Tract 4425, Alameda County, California",2045,131,1106,173,939,187
6001442600,"Census Tract 4426, Alameda County, California",2823,96,2022,150,801,141
6001442700,"Census Tract 4427, Alameda County, California",1018,55,780,68,238,58
6001442800,"Census Tract 4428, Alameda County, California",789,96,571,95,218,95
6001442900,"Census Tract 4429, Alameda County, California",2004,170,1387,166,617,170
6001443001,"Census Tract 4430.01, Alameda County, California",779,47,636,69,143,60
6001443002,"Census Tract 4430.02, Alameda County, California",1660,102,1294,143,366,109
6001443101,"Census Tract 4431.01, Alameda County, California",2811,139,2299,163,512,132
6001443102,"Census Tract 4431.02, Alameda County, California",1367,69,1160,98,207,73
6001443103,"Census Tract 4431.03, Alameda County, California",998,81,942,93,56,43
6001443200,"Census Tract 4432, Alameda County, California",1065,58,1043,59,22,23
6001443301,"Census Tract 4433.01, Alameda County, California",1162,59,1090,76,72,52
6001443302,"Census Tract 4433.02, Alameda County, California",1996,116,1337,158,659,141
6001444100,"Census Tract 4441, Alameda County, California",2446,115,2163,146,283,95
6001444200,"Census Tract 4442, Alameda County, California",1865,96,1460,135,405,134
6001444300,"Census Tract 4443, Alameda County, California",2420,116,1550,171,870,176
6001444400,"Census Tract 4444, Alameda County, California",1334,111,918,119,416,104
6001444500,"Census Tract 4445, Alameda County, California",1827,124,1093,160,734,138
6001444600,"Census Tract 4446, Alameda County, California",2850,166,2107,192,743,203
6001450100,"Census Tract 4501, Alameda County, California",2671,125,1369,118,1302,135
6001450200,"Census Tract 4502, Alameda County, California",2090,121,641,115,1449,157
6001450300,"Census Tract 4503, Alameda County, California",1724,91,1102,120,622,125
6001450400,"Census Tract 4504, Alameda County, California",1963,87,1424,156,539,144
6001450500,"Census Tract 4505, Alameda County, California",2685,83,2379,118,306,87
6001450601,"Census Tract 4506.01, Alameda County, California",1175,70,1056,68,119,57
6001450602,"Census Tract 4506.02, Alameda County, California",3092,128,2073,153,1019,140
6001450603,"Census Tract 4506.03, Alameda County, California",1375,61,1176,112,199,91
6001450604,"Census Tract 4506.04, Alameda County, California",1576,53,1240,93,336,87
6001450605,"Census Tract 4506.05, Alameda County, California",1223,97,976,91,247,97
6001450606,"Census Tract 4506.06, Alameda County, California",1837,58,1588,88,249,73
6001450607,"Census Tract 4506.07, Alameda County, California",1812,84,531,82,1281,109
6001450701,"Census Tract 4507.01, Alameda County, California",2450,82,2101,118,349,107
6001450703,"Census Tract 4507.03, Alameda County, California",2642,103,1996,158,646,161
6001450721,"Census Tract 4507.21, Alameda County, California",2657,181,2233,186,424,140
6001450722,"Census Tract 4507.22, Alameda County, California",3561,149,1951,168,1610,190
6001450741,"Census Tract 4507.41, Alameda County, California",1643,71,1015,112,628,101
6001450742,"Census Tract 4507.42, Alameda County, California",1636,80,1321,107,315,78
6001451101,"Census Tract 4511.01, Alameda County, California",2183,102,1656,143,527,144
6001451102,"Census Tract 4511.02, Alameda County, California",1286,59,1221,68,65,48
6001451201,"Census Tract 4512.01, Alameda County, California",2406,135,1675,183,731,166
6001451202,"Census Tract 4512.02, Alameda County, California",1130,75,972,76,158,67
6001451300,"Census Tract 4513, Alameda County, California",2304,85,1961,138,343,117
6001451401,"Census Tract 4514.01, Alameda County, California",1987,131,1407,165,580,165
6001451402,"Census Tract 4514.02, Alameda County, California",2805,128,1451,221,1354,220
6001451501,"Census Tract 4515.01, Alameda County, California",1715,62,1146,88,569,80
6001451502,"Census Tract 4515.02, Alameda County, California",2619,159,1930,178,689,166
6001451503,"Census Tract 4515.03, Alameda County, California",1980,101,1235,160,745,134
6001451601,"Census Tract 4516.01, Alameda County, California",1643,78,1137,116,506,110
6001451602,"Census Tract 4516.02, Alameda County, California",2464,126,1480,152,984,171
6001451701,"Census Tract 4517.01, Alameda County, California",1037,38,778,84,259,85
6001451702,"Census Tract 4517.02, Alameda County, California",2891,91,2490,101,401,107
6003010000,"Census Tract 100, Alpine County, California",444,76,296,50,148,64
6005000100,"Census Tract 1, Amador County, California",2871,225,2572,241,299,165
6005000200,"Census Tract 2, Amador County, California",2089,171,1687,168,402,133
6005000301,"Census Tract 3.01, Amador County, California",684,69,525,65,159,73
6005000302,"Census Tract 3.02, Amador County, California",3343,235,2445,230,898,218
6005000401,"Census Tract 4.01, Amador County, California",1966,184,1361,192,605,146
6005000402,"Census Tract 4.02, Amador County, California",2192,137,1789,185,403,159
6005000500,"Census Tract 5, Amador County, California",1219,174,846,174,373,120
6007000101,"Census Tract 1.01, Butte County, California",3065,178,1639,179,1426,244
6007000102,"Census Tract 1.02, Butte County, California",1468,120,991,145,477,124
6007000201,"Census Tract 2.01, Butte County, California",1550,127,835,99,715,128
6007000202,"Census Tract 2.02, Butte County, California",1667,125,830,110,837,139
6007000300,"Census Tract 3, Butte County, California",1586,150,551,113,1035,162
6007000400,"Census Tract 4, Butte County, California",3413,153,2304,163,1109,185
6007000501,"Census Tract 5.01, Butte County, California",1495,140,947,92,548,158
6007000502,"Census Tract 5.02, Butte County, California",1956,207,340,67,1616,206
6007000601,"Census Tract 6.01, Butte County, California",1325,87,762,77,563,102
6007000603,"Census Tract 6.03, Butte County, California",1140,92,217,76,923,103
6007000604,"Census Tract 6.04, Butte County, California",1666,163,148,51,1518,157
6007000700,"Census Tract 7, Butte County, California",2357,193,955,153,1402,228
6007000800,"Census Tract 8, Butte County, California",2148,156,1411,136,737,171
6007000900,"Census Tract 9, Butte County, California",5833,269,2865,228,2968,308
6007001000,"Census Tract 10, Butte County, California",2085,192,450,115,1635,200
6007001100,"Census Tract 11, Butte County, California",1749,139,658,75,1091,158
6007001200,"Census Tract 12, Butte County, California",1460,117,406,87,1054,143
6007001300,"Census Tract 13, Butte County, California",1321,140,438,93,883,156
6007001400,"Census Tract 14, Butte County, California",2122,129,1842,124,280,106
6007001500,"Census Tract 15, Butte County, California",1984,131,1362,126,622,140
6007001600,"Census Tract 16, Butte County, California",2084,175,1882,175,202,87
6007001701,"Census Tract 17.01, Butte County, California",2508,186,2074,202,434,179
6007001702,"Census Tract 17.02, Butte County, California",2429,191,2001,206,428,142
6007001800,"Census Tract 18, Butte County, California",2690,166,2134,170,556,175
6007001900,"Census Tract 19, Butte County, California",1501,127,1245,145,256,87
6007002000,"Census Tract 20, Butte County, California",2193,211,1438,192,755,161
6007002100,"Census Tract 21, Butte County, California",2202,156,1466,210,736,169
6007002200,"Census Tract 22, Butte County, California",2325,169,1720,180,605,167
6007002300,"Census Tract 23, Butte County, California",2383,168,1985,171,398,118
6007002400,"Census Tract 24, Butte County, California",2126,146,1756,147,370,115
6007002500,"Census Tract 25, Butte County, California",1417,125,591,109,826,108
6007002600,"Census Tract 26, Butte County, California",2655,174,2197,165,458,154
6007002700,"Census Tract 27, Butte County, California",2065,185,1220,169,845,184
6007002800,"Census Tract 28, Butte County, California",1679,190,480,92,1199,173
6007002900,"Census Tract 29, Butte County, California",2478,218,1735,201,743,206
6007003000,"Census Tract 30, Butte County, California",2014,191,1160,164,854,173
6007003100,"Census Tract 31, Butte County, California",1677,118,1366,102,311,127
6007003200,"Census Tract 32, Butte County, California",1400,171,1169,145,231,111
6007003300,"Census Tract 33, Butte County, California",1549,122,1351,130,198,68
6007003400,"Census Tract 34, Butte County, California",992,89,542,97,450,84
6007003500,"Census Tract 35, Butte County, California",2364,259,1445,274,919,171
6007003600,"Census Tract 36, Butte County, California",1086,135,769,128,317,96
6009000110,"Census Tract 1.10, Calaveras County, California",3754,317,2574,332,1180,251
6009000120,"Census Tract 1.20, Calaveras County, California",1633,193,1315,211,318,134
6009000210,"Census Tract 2.10, Calaveras County, California",3527,262,3179,277,348,150
6009000220,"Census Tract 2.20, Calaveras County, California",2191,149,1985,150,206,100
6009000300,"Census Tract 3, Calaveras County, California",2752,223,1926,235,826,174
6009000400,"Census Tract 4, Calaveras County, California",1871,201,1543,207,328,116
6009000500,"Census Tract 5, Calaveras County, California",2425,314,1971,272,454,192
6011000100,"Census Tract 1, Colusa County, California",1615,163,971,185,644,176
6011000200,"Census Tract 2, Colusa County, California",1784,121,1312,149,472,117
6011000300,"Census Tract 3, Colusa County, California",1426,484,808,312,618,233
6011000400,"Census Tract 4, Colusa County, California",838,100,586,71,252,71
6011000500,"Census Tract 5, Colusa County, California",1027,127,677,130,350,115
6013301000,"Census Tract 3010, Contra Costa County, California",1574,166,1267,188,307,138
6013302002,"Census Tract 3020.02, Contra Costa County, California",3044,199,2108,238,936,217
6013302003,"Census Tract 3020.03, Contra Costa County, California",3417,209,2834,233,583,164
6013302004,"Census Tract 3020.04, Contra Costa County, California",3979,212,3279,243,700,217
6013303100,"Census Tract 3031, Contra Costa County, California",4723,225,3439,246,1284,224
6013303200,"Census Tract 3032, Contra Costa County, California",12143,416,10575,461,1568,298
6013304000,"Census Tract 3040, Contra Costa County, California",6106,349,5344,393,762,258
6013305000,"Census Tract 3050, Contra Costa County, California",2047,183,625,105,1422,200
6013306001,"Census Tract 3060.01, Contra Costa County, California",2766,178,1543,225,1223,229
6013306002,"Census Tract 3060.02, Contra Costa County, California",1121,78,895,108,226,93
6013307101,"Census Tract 3071.01, Contra Costa County, California",1452,71,1028,118,424,113
6013307102,"Census Tract 3071.02, Contra Costa County, California",1675,120,1004,132,671,152
6013307201,"Census Tract 3072.01, Contra Costa County, California",832,78,444,89,388,79
6013307202,"Census Tract 3072.02, Contra Costa County, California",1328,139,400,125,928,159
6013307204,"Census Tract 3072.04, Contra Costa County, California",1282,75,1074,95,208,80
6013307205,"Census Tract 3072.05, Contra Costa County, California",2447,169,1275,242,1172,249
6013308001,"Census Tract 3080.01, Contra Costa County, California",2270,169,1659,186,611,154
6013308002,"Census Tract 3080.02, Contra Costa County, California",1352,72,1204,96,148,87
6013309000,"Census Tract 3090, Contra Costa County, California",1011,91,764,102,247,88
6013310000,"Census Tract 3100, Contra Costa County, California",1443,108,752,126,691,129
6013311000,"Census Tract 3110, Contra Costa County, California",1343,114,575,117,768,153
6013312000,"Census Tract 3120, Contra Costa County, California",789,78,357,90,432,93
6013313101,"Census Tract 3131.01, Contra Costa County, California",2862,206,1463,165,1399,190
6013313102,"Census Tract 3131.02, Contra Costa County, California",1340,96,758,108,582,108
6013313103,"Census Tract 3131.03, Contra Costa County, California",2376,136,1506,172,870,173
6013313201,"Census Tract 3132.01, Contra Costa County, California",2269,111,1554,165,715,159
6013313202,"Census Tract 3132.02, Contra Costa County, California",2895,147,2093,211,802,212
6013314102,"Census Tract 3141.02, Contra Costa County, California",1766,138,1418,164,348,133
6013314103,"Census Tract 3141.03, Contra Costa County, California",1710,106,820,123,890,137
6013314104,"Census Tract 3141.04, Contra Costa County, California",2392,168,1342,170,1050,173
6013314200,"Census Tract 3142, Contra Costa County, California",1812,119,1401,168,411,119
6013315000,"Census Tract 3150, Contra Costa County, California",1375,40,1222,81,153,73
6013316000,"Census Tract 3160, Contra Costa County, California",384,57,25,33,359,52
6013317000,"Census Tract 3170, Contra Costa County, California",1020,85,456,90,564,104
6013318000,"Census Tract 3180, Contra Costa County, California",1616,86,783,119,833,123
6013319000,"Census Tract 3190, Contra Costa County, California",3106,141,1960,213,1146,207
6013320001,"Census Tract 3200.01, Contra Costa County, California",1244,107,883,111,361,108
6013320002,"Census Tract 3200.02, Contra Costa County, California",3406,166,2645,168,761,189
6013321101,"Census Tract 3211.01, Contra Costa County, California",2482,134,2006,171,476,162
6013321102,"Census Tract 3211.02, Contra Costa County, California",2767,83,2622,105,145,79
6013321103,"Census Tract 3211.03, Contra Costa County, California",1851,87,1509,109,342,89
6013321200,"Census Tract 3212, Contra Costa County, California",2333,126,1312,173,1021,154
6013322000,"Census Tract 3220, Contra Costa County, California",2412,117,1874,161,538,158
6013323000,"Census Tract 3230, Contra Costa County, California",1585,113,1339,120,246,75
6013324000,"Census Tract 3240, Contra Costa County, California",4979,206,1293,199,3686,247
6013325000,"Census Tract 3250, Contra Costa County, California",2032,146,1467,160,565,153
6013326000,"Census Tract 3260, Contra Costa County, California",1321,55,1144,72,177,73
6013327000,"Census Tract 3270, Contra Costa County, California",2772,154,2247,173,525,162
6013328000,"Census Tract 3280, Contra Costa County, California",1087,79,94,57,993,98
6013329000,"Census Tract 3290, Contra Costa County, California",2270,103,1334,220,936,213
6013330000,"Census Tract 3300, Contra Costa County, California",1834,94,1498,129,336,109
6013331000,"Census Tract 3310, Contra Costa County, California",2568,143,1607,185,961,178
6013332000,"Census Tract 3320, Contra Costa County, California",2759,109,2078,177,681,166
6013333100,"Census Tract 3331, Contra Costa County, California",3078,91,2184,139,894,147
6013333200,"Census Tract 3332, Contra Costa County, California",2123,98,1598,169,525,141
6013334001,"Census Tract 3340.01, Contra Costa County, California",1441,43,801,119,640,115
6013334003,"Census Tract 3340.03, Contra Costa County, California",1262,48,1138,67,124,50
6013334004,"Census Tract 3340.04, Contra Costa County, California",3081,187,1704,168,1377,210
6013334005,"Census Tract 3340.05, Contra Costa County, California",405,50,302,65,103,64
6013335000,"Census Tract 3350, Contra Costa County, California",1221,89,966,102,255,92
6013336101,"Census Tract 3361.01, Contra Costa County, California",1426,110,268,69,1158,114
6013336102,"Census Tract 3361.02, Contra Costa County, California",2553,113,575,181,1978,188
6013336200,"Census Tract 3362, Contra Costa County, California",2490,131,1013,160,1477,179
6013337100,"Census Tract 3371, Contra Costa County, California",1166,47,863,87,303,88
6013337200,"Census Tract 3372, Contra Costa County, California",2976,141,2091,206,885,193
6013337300,"Census Tract 3373, Contra Costa County, California",2324,61,1856,145,468,142
6013338100,"Census Tract 3381, Contra Costa County, California",2963,138,2174,183,789,193
6013338201,"Census Tract 3382.01, Contra Costa County, California",1403,46,1266,84,137,75
6013338202,"Census Tract 3382.02, Contra Costa County, California",5546,234,2936,267,2610,231
6013338301,"Census Tract 3383.01, Contra Costa County, California",1037,45,1029,45,8,12
6013338302,"Census Tract 3383.02, Contra Costa County, California",2162,54,2068,77,94,50
6013339000,"Census Tract 3390, Contra Costa County, California",4459,230,968,188,3491,276
6013340001,"Census Tract 3400.01, Contra Costa County, California",2391,146,1279,158,1112,185
6013340002,"Census Tract 3400.02, Contra Costa County, California",3177,64,2480,168,697,162
6013341000,"Census Tract 3410, Contra Costa County, California",2223,91,1652,116,571,123
6013342000,"Census Tract 3420, Contra Costa County, California",2351,110,1756,117,595,134
6013343001,"Census Tract 3430.01, Contra Costa County, California",2143,86,1124,133,1019,139
6013343002,"Census Tract 3430.02, Contra Costa County, California",2073,96,1512,127,561,108
6013343003,"Census Tract 3430.03, Contra Costa County, California",1513,75,1338,71,175,54
6013344000,"Census Tract 3440, Contra Costa County, California",479,50,346,78,133,77
6013345101,"Census Tract 3451.01, Contra Costa County, California",1567,103,1168,100,399,112
6013345102,"Census Tract 3451.02, Contra Costa County, California",1066,37,926,76,140,66
6013345103,"Census Tract 3451.03, Contra Costa County, California",1503,62,1188,83,315,78
6013345105,"Census Tract 3451.05, Contra Costa County, California",1941,102,1644,145,297,114
6013345107,"Census Tract 3451.07, Contra Costa County, California",3648,118,3324,155,324,112
6013345108,"Census Tract 3451.08, Contra Costa County, California",2502,110,1836,166,666,154
6013345109,"Census Tract 3451.09, Contra Costa County, California",3118,131,2007,137,1111,154
6013345110,"Census Tract 3451.10, Contra Costa County, California",2098,101,1820,122,278,92
6013345201,"Census Tract 3452.01, Contra Costa County, California",3875,159,3347,183,528,132
6013345202,"Census Tract 3452.02, Contra Costa County, California",2671,70,1609,181,1062,178
6013346101,"Census Tract 3461.01, Contra Costa County, California",1343,51,1247,66,96,46
6013346102,"Census Tract 3461.02, Contra Costa County, California",2068,99,1997,121,71,59
6013346201,"Census Tract 3462.01, Contra Costa County, California",2621,93,2418,126,203,84
6013346202,"Census Tract 3462.02, Contra Costa County, California",3715,134,3358,169,357,115
6013347000,"Census Tract 3470, Contra Costa County, California",2322,71,2172,120,150,102
6013348000,"Census Tract 3480, Contra Costa County, California",1549,92,1394,96,155,69
6013349000,"Census Tract 3490, Contra Costa County, California",1850,120,1084,103,766,132
6013350000,"Census Tract 3500, Contra Costa County, California",2387,107,1329,122,1058,130
6013351100,"Census Tract 3511, Contra Costa County, California",5970,247,5566,240,404,147
6013351200,"Census Tract 3512, Contra Costa County, California",2078,83,1967,106,111,81
6013352101,"Census Tract 3521.01, Contra Costa County, California",778,64,724,68,54,44
6013352102,"Census Tract 3521.02, Contra Costa County, California",1831,99,1684,128,147,71
6013352201,"Census Tract 3522.01, Contra Costa County, California",2242,79,1714,159,528,149
6013352202,"Census Tract 3522.02, Contra Costa County, California",941,51,794,93,147,81
6013353001,"Census Tract 3530.01, Contra Costa County, California",1372,56,1222,90,150,73
6013353002,"Census Tract 3530.02, Contra Costa County, California",1451,62,1351,68,100,53
6013354001,"Census Tract 3540.01, Contra Costa County, California",638,69,608,71,30,27
6013354002,"Census Tract 3540.02, Contra Costa County, California",2558,103,2345,125,213,91
6013355101,"Census Tract 3551.01, Contra Costa County, California",5108,201,4404,294,704,218
6013355104,"Census Tract 3551.04, Contra Costa County, California",8875,233,7670,280,1205,223
6013355106,"Census Tract 3551.06, Contra Costa County, California",4872,228,4128,264,744,197
6013355200,"Census Tract 3552, Contra Costa County, California",1753,99,1093,149,660,169
6013355301,"Census Tract 3553.01, Contra Costa County, California",2784,97,2401,134,383,126
6013355302,"Census Tract 3553.02, Contra Costa County, California",1225,40,1191,42,34,25
6013355303,"Census Tract 3553.03, Contra Costa County, California",452,15,354,63,98,64
6013355304,"Census Tract 3553.04, Contra Costa County, California",2845,125,2434,142,411,125
6013355305,"Census Tract 3553.05, Contra Costa County, California",1407,78,1327,92,80,51
6013356001,"Census Tract 3560.01, Contra Costa County, California",1317,52,1070,116,247,114
6013356002,"Census Tract 3560.02, Contra Costa County, California",2432,145,2225,145,207,117
6013357000,"Census Tract 3570, Contra Costa County, California",1633,113,1108,156,525,146
6013358000,"Census Tract 3580, Contra Costa County, California",2124,112,1225,165,899,196
6013359101,"Census Tract 3591.01, Contra Costa County, California",5291,220,4019,264,1272,234
6013359102,"Census Tract 3591.02, Contra Costa County, California",1686,130,1200,130,486,114
6013359202,"Census Tract 3592.02, Contra Costa County, California",2161,153,1989,160,172,81
6013359203,"Census Tract 3592.03, Contra Costa County, California",2472,121,1924,200,548,163
6013359204,"Census Tract 3592.04, Contra Costa County, California",1425,93,1225,110,200,75
6013360100,"Census Tract 3601, Contra Costa County, California",3332,140,2912,171,420,126
6013360200,"Census Tract 3602, Contra Costa County, California",1873,128,1187,142,686,151
6013361000,"Census Tract 3610, Contra Costa County, California",1583,117,1048,126,535,157
6013362000,"Census Tract 3620, Contra Costa County, California",1125,94,927,98,198,89
6013363000,"Census Tract 3630, Contra Costa County, California",2891,107,1839,202,1052,187
6013364001,"Census Tract 3640.01, Contra Costa County, California",1670,49,1393,107,277,100
6013364002,"Census Tract 3640.02, Contra Costa County, California",1957,101,1392,132,565,131
6013365001,"Census Tract 3650.01, Contra Costa County, California",3558,195,1502,157,2056,198
6013365002,"Census Tract 3650.02, Contra Costa County, California",1345,104,637,120,708,147
6013366001,"Census Tract 3660.01, Contra Costa County, California",1341,79,846,116,495,109
6013366002,"Census Tract 3660.02, Contra Costa County, California",1677,115,954,126,723,136
6013367100,"Census Tract 3671, Contra Costa County, California",1943,141,1088,151,855,170
6013367200,"Census Tract 3672, Contra Costa County, California",1629,85,1101,128,528,115
6013368000,"Census Tract 3680, Contra Costa County, California",2140,189,1194,168,946,181
6013369001,"Census Tract 3690.01, Contra Costa County, California",2600,190,998,188,1602,207
6013369002,"Census Tract 3690.02, Contra Costa County, California",1098,82,595,98,503,109
6013370000,"Census Tract 3700, Contra Costa County, California",1173,83,866,122,307,119
6013371000,"Census Tract 3710, Contra Costa County, California",2004,113,1295,149,709,141
6013372000,"Census Tract 3720, Contra Costa County, California",2303,169,1776,182,527,156
6013373000,"Census Tract 3730, Contra Costa County, California",1134,92,760,124,374,122
6013374000,"Census Tract 3740, Contra Costa County, California",1742,147,1000,161,742,161
6013375000,"Census Tract 3750, Contra Costa County, California",1149,114,483,91,666,123
6013376000,"Census Tract 3760, Contra Costa County, California",1749,130,702,107,1047,139
6013377000,"Census Tract 3770, Contra Costa County, California",1937,190,843,152,1094,197
6013378000,"Census Tract 3780, Contra Costa County, California",1434,134,917,134,517,114
6013379000,"Census Tract 3790, Contra Costa County, California",1623,148,781,133,842,153
6013380000,"Census Tract 3800, Contra Costa County, California",2388,230,1204,203,1184,235
6013381000,"Census Tract 3810, Contra Costa County, California",1829,163,708,177,1121,200
6013382000,"Census Tract 3820, Contra Costa County, California",2470,203,974,193,1496,220
6013383000,"Census Tract 3830, Contra Costa County, California",2141,96,1338,178,803,172
6013384000,"Census Tract 3840, Contra Costa County, California",1487,82,1340,102,147,72
6013385100,"Census Tract 3851, Contra Costa County, California",1023,68,887,79,136,50
6013385200,"Census Tract 3852, Contra Costa County, California",459,54,456,55,3,8
6013386000,"Census Tract 3860, Contra Costa County, California",1316,90,304,72,1012,103
6013387000,"Census Tract 3870, Contra Costa County, California",987,67,639,92,348,76
6013388000,"Census Tract 3880, Contra Costa County, California",1018,76,508,87,510,98
6013389100,"Census Tract 3891, Contra Costa County, California",811,63,382,65,429,78
6013389200,"Census Tract 3892, Contra Costa County, California",760,42,97,43,663,56
6013390100,"Census Tract 3901, Contra Costa County, California",859,50,701,83,158,82
6013390200,"Census Tract 3902, Contra Costa County, California",723,37,652,51,71,36
6013391000,"Census Tract 3910, Contra Costa County, California",1195,51,1072,66,123,51
6013392000,"Census Tract 3920, Contra Costa County, California",1060,75,953,89,107,51
6015000101,"Census Tract 1.01, Del Norte County, California",1824,186,547,123,1277,186
6015000102,"Census Tract 1.02, Del Norte County, California",1309,151,996,156,313,132
6015000103,"Census Tract 1.03, Del Norte County, California",3415,229,2278,240,1137,210
6015000201,"Census Tract 2.01, Del Norte County, California",1290,116,1076,125,214,108
6015000202,"Census Tract 2.02, Del Norte County, California",1434,150,1092,146,342,116
6015000203,"Census Tract 2.03, Del Norte County, California",478,69,291,63,187,69
6017030101,"Census Tract 301.01, El Dorado County, California",193,86,67,70,126,78
6017030102,"Census Tract 301.02, El Dorado County, California",1424,187,274,124,1150,162
6017030200,"Census Tract 302, El Dorado County, California",1753,170,792,180,961,180
6017030300,"Census Tract 303, El Dorado County, California",2391,227,927,224,1464,246
6017030401,"Census Tract 304.01, El Dorado County, California",1768,212,1076,187,692,189
6017030402,"Census Tract 304.02, El Dorado County, California",1829,197,709,157,1120,221
6017030501,"Census Tract 305.01, El Dorado County, California",1947,226,1470,238,477,154
6017030502,"Census Tract 305.02, El Dorado County, California",1007,127,864,131,143,82
6017030503,"Census Tract 305.03, El Dorado County, California",322,89,237,77,85,66
6017030601,"Census Tract 306.01, El Dorado County, California",1884,122,1699,115,185,82
6017030602,"Census Tract 306.02, El Dorado County, California",2398,138,2168,177,230,124
6017030603,"Census Tract 306.03, El Dorado County, California",1162,100,931,126,231,90
6017030701,"Census Tract 307.01, El Dorado County, California",2121,103,1891,123,230,95
6017030702,"Census Tract 307.02, El Dorado County, California",2984,126,2424,148,560,111
6017030703,"Census Tract 307.03, El Dorado County, California",5286,210,4812,225,474,127
6017030704,"Census Tract 307.04, El Dorado County, California",1901,115,1430,147,471,125
6017030801,"Census Tract 308.01, El Dorado County, California",1309,90,1163,110,146,93
6017030803,"Census Tract 308.03, El Dorado County, California",2506,149,2159,141,347,102
6017030804,"Census Tract 308.04, El Dorado County, California",1972,205,1710,196,262,107
6017030805,"Census Tract 308.05, El Dorado County, California",3889,112,3004,193,885,157
6017030806,"Census Tract 308.06, El Dorado County, California",2076,165,1319,140,757,144
6017030901,"Census Tract 309.01, El Dorado County, California",976,71,910,78,66,51
6017030902,"Census Tract 309.02, El Dorado County, California",1742,74,1535,97,207,95
6017031000,"Census Tract 310, El Dorado County, California",2267,151,1777,205,490,141
6017031100,"Census Tract 311, El Dorado County, California",2154,167,1367,182,787,169
6017031200,"Census Tract 312, El Dorado County, California",1798,139,1257,134,541,109
6017031301,"Census Tract 313.01, El Dorado County, California",1159,150,1010,130,149,81
6017031302,"Census Tract 313.02, El Dorado County, California",1932,174,1474,172,458,144
6017031402,"Census Tract 314.02, El Dorado County, California",2018,155,1907,175,111,62
6017031403,"Census Tract 314.03, El Dorado County, California",45,20,35,16,10,11
6017031404,"Census Tract 314.04, El Dorado County, California",842,79,788,87,54,50
6017031405,"Census Tract 314.05, El Dorado County, California",948,96,775,106,173,80
6017031406,"Census Tract 314.06, El Dorado County, California",1993,149,1848,142,145,76
6017031502,"Census Tract 315.02, El Dorado County, California",2292,177,1526,173,766,173
6017031503,"Census Tract 315.03, El Dorado County, California",1071,68,960,82,111,64
6017031504,"Census Tract 315.04, El Dorado County, California",2020,157,1704,191,316,136
6019000100,"Census Tract 1, Fresno County, California",389,54,16,18,373,56
6019000200,"Census Tract 2, Fresno County, California",731,73,133,65,598,95
6019000300,"Census Tract 3, Fresno County, California",902,112,368,88,534,117
6019000400,"Census Tract 4, Fresno County, California",1192,91,638,99,554,121
6019000500,"Census Tract 5, Fresno County, California",1669,115,327,76,1342,114
6019000600,"Census Tract 6, Fresno County, California",1871,134,216,80,1655,148
6019000700,"Census Tract 7, Fresno County, California",1164,90,615,112,549,119
6019000800,"Census Tract 8, Fresno County, California",128,36,72,30,56,27
6019000900,"Census Tract 9, Fresno County, California",1732,107,610,135,1122,136
6019001000,"Census Tract 10, Fresno County, California",886,85,382,82,504,107
6019001100,"Census Tract 11, Fresno County, California",744,57,235,73,509,86
6019001201,"Census Tract 12.01, Fresno County, California",1305,96,603,95,702,125
6019001202,"Census Tract 12.02, Fresno County, California",1016,63,376,111,640,128
6019001301,"Census Tract 13.01, Fresno County, California",1316,101,749,115,567,115
6019001302,"Census Tract 13.02, Fresno County, California",1909,95,587,95,1322,131
6019001403,"Census Tract 14.03, Fresno County, California",2154,141,1098,142,1056,159
6019001404,"Census Tract 14.04, Fresno County, California",2462,145,2162,173,300,106
6019001405,"Census Tract 14.05, Fresno County, California",2708,153,621,149,2087,197
6019001406,"Census Tract 14.06, Fresno County, California",2284,144,1794,175,490,133
6019001500,"Census Tract 15, Fresno County, California",655,79,422,117,233,95
6019001600,"Census Tract 16, Fresno County, California",1607,178,920,146,687,151
6019001700,"Census Tract 17, Fresno County, California",1422,92,837,89,585,102
6019001800,"Census Tract 18, Fresno County, California",1284,80,808,92,476,81
6019001900,"Census Tract 19, Fresno County, California",794,73,501,49,293,60
6019002000,"Census Tract 20, Fresno County, California",1848,115,787,132,1061,146
6019002100,"Census Tract 21, Fresno County, California",2110,110,1076,158,1034,162
6019002200,"Census Tract 22, Fresno County, California",1569,106,516,108,1053,123
6019002300,"Census Tract 23, Fresno County, California",1200,117,497,125,703,136
6019002400,"Census Tract 24, Fresno County, California",1282,89,354,100,928,128
6019002501,"Census Tract 25.01, Fresno County, California",1278,88,449,104,829,129
6019002502,"Census Tract 25.02, Fresno County, California",1206,72,273,84,933,92
6019002601,"Census Tract 26.01, Fresno County, California",1355,87,606,123,749,126
6019002602,"Census Tract 26.02, Fresno County, California",1001,61,571,99,430,109
6019002701,"Census Tract 27.01, Fresno County, California",1170,78,763,106,407,117
6019002702,"Census Tract 27.02, Fresno County, California",1408,76,355,86,1053,98
6019002800,"Census Tract 28, Fresno County, California",1209,96,367,92,842,123
6019002901,"Census Tract 29.01, Fresno County, California",2306,137,956,156,1350,173
6019002902,"Census Tract 29.02, Fresno County, California",2145,109,724,116,1421,132
6019003001,"Census Tract 30.01, Fresno County, California",866,83,347,88,519,104
6019003002,"Census Tract 30.02, Fresno County, California",1932,98,827,132,1105,118
6019003101,"Census Tract 31.01, Fresno County, California",3889,113,1469,186,2420,195
6019003102,"Census Tract 31.02, Fresno County, California",2763,165,698,129,2065,192
6019003201,"Census Tract 32.01, Fresno County, California",1462,73,848,115,614,122
6019003202,"Census Tract 32.02, Fresno County, California",1587,92,739,110,848,129
6019003300,"Census Tract 33, Fresno County, California",2297,198,1265,184,1032,212
6019003400,"Census Tract 34, Fresno County, California",1502,110,726,126,776,124
6019003500,"Census Tract 35, Fresno County, California",2170,104,1079,165,1091,182
6019003600,"Census Tract 36, Fresno County, California",1631,127,1243,142,388,107
6019003700,"Census Tract 37, Fresno County, California",2740,115,1102,149,1638,133
6019003801,"Census Tract 38.01, Fresno County, California",2624,118,1537,229,1087,233
6019003803,"Census Tract 38.03, Fresno County, California",1798,130,1480,135,318,114
6019003804,"Census Tract 38.04, Fresno County, California",1460,79,1099,102,361,98
6019003805,"Census Tract 38.05, Fresno County, California",1898,90,939,133,959,140
6019003806,"Census Tract 38.06, Fresno County, California",2478,132,1662,231,816,189
6019003900,"Census Tract 39, Fresno County, California",1345,155,669,143,676,151
6019004000,"Census Tract 40, Fresno County, California",3561,269,2213,276,1348,230
6019004100,"Census Tract 41, Fresno County, California",875,72,399,100,476,119
6019004205,"Census Tract 42.05, Fresno County, California",2095,127,846,167,1249,163
6019004206,"Census Tract 42.06, Fresno County, California",2198,74,1690,183,508,182
6019004207,"Census Tract 42.07, Fresno County, California",1508,119,1036,135,472,102
6019004208,"Census Tract 42.08, Fresno County, California",2371,73,2041,124,330,124
6019004209,"Census Tract 42.09, Fresno County, California",3146,112,2024,164,1122,167
6019004210,"Census Tract 42.10, Fresno County, California",1371,98,542,112,829,112
6019004211,"Census Tract 42.11, Fresno County, California",2094,87,1568,162,526,164
6019004212,"Census Tract 42.12, Fresno County, California",3501,177,1197,140,2304,199
6019004301,"Census Tract 43.01, Fresno County, California",1438,86,1327,100,111,54
6019004302,"Census Tract 43.02, Fresno County, California",1975,72,1643,118,332,106
6019004303,"Census Tract 43.03, Fresno County, California",1907,41,1611,99,296,91
6019004404,"Census Tract 44.04, Fresno County, California",1189,76,150,64,1039,97
6019004405,"Census Tract 44.05, Fresno County, California",1462,58,1305,66,157,70
6019004406,"Census Tract 44.06, Fresno County, California",2379,93,1034,142,1345,159
6019004407,"Census Tract 44.07, Fresno County, California",3123,160,1311,153,1812,202
6019004503,"Census Tract 45.03, Fresno County, California",2091,77,1267,137,824,166
6019004504,"Census Tract 45.04, Fresno County, California",2207,117,888,140,1319,168
6019004505,"Census Tract 45.05, Fresno County, California",1700,132,506,110,1194,119
6019004506,"Census Tract 45.06, Fresno County, California",1489,91,1066,95,423,95
6019004601,"Census Tract 46.01, Fresno County, California",1162,32,797,95,365,97
6019004602,"Census Tract 46.02, Fresno County, California",1038,66,775,86,263,96
6019004701,"Census Tract 47.01, Fresno County, California",2170,161,953,151,1217,172
6019004703,"Census Tract 47.03, Fresno County, California",1335,46,655,116,680,127
6019004704,"Census Tract 47.04, Fresno County, California",1548,114,562,100,986,142
6019004800,"Census Tract 48, Fresno County, California",3058,173,875,192,2183,248
6019004900,"Census Tract 49, Fresno County, California",2116,183,1021,157,1095,179
6019005000,"Census Tract 50, Fresno County, California",1418,78,901,108,517,123
6019005100,"Census Tract 51, Fresno County, California",2065,137,820,141,1245,177
6019005201,"Census Tract 52.01, Fresno County, California",3001,109,1529,190,1472,181
6019005202,"Census Tract 52.02, Fresno County, California",1162,76,389,87,773,99
6019005301,"Census Tract 53.01, Fresno County, California",1839,106,1024,147,815,153
6019005302,"Census Tract 53.02, Fresno County, California",2076,81,741,113,1335,125
6019005304,"Census Tract 53.04, Fresno County, California",2297,103,718,118,1579,159
6019005305,"Census Tract 53.05, Fresno County, California",1050,99,588,122,462,118
6019005403,"Census Tract 54.03, Fresno County, California",1393,147,247,58,1146,156
6019005404,"Census Tract 54.04, Fresno County, California",2650,139,1127,148,1523,184
6019005405,"Census Tract 54.05, Fresno County, California",1551,55,1132,92,419,89
6019005406,"Census Tract 54.06, Fresno County, California",1379,81,1096,119,283,101
6019005407,"Census Tract 54.07, Fresno County, California",1141,108,759,72,382,93
6019005408,"Census Tract 54.08, Fresno County, California",0,132,0,132,0,132
6019005503,"Census Tract 55.03, Fresno County, California",1645,101,1153,124,492,101
6019005504,"Census Tract 55.04, Fresno County, California",706,88,565,97,141,69
6019005505,"Census Tract 55.05, Fresno County, California",2134,95,1846,113,288,126
6019005506,"Census Tract 55.06, Fresno County, California",4591,272,3053,214,1538,251
6019005507,"Census Tract 55.07, Fresno County, California",2177,61,1522,157,655,148
6019005508,"Census Tract 55.08, Fresno County, California",1709,107,1380,139,329,110
6019005509,"Census Tract 55.09, Fresno County, California",1411,76,932,107,479,97
6019005510,"Census Tract 55.10, Fresno County, California",2108,122,1008,109,1100,142
6019005511,"Census Tract 55.11, Fresno County, California",3964,194,3566,235,398,134
6019005512,"Census Tract 55.12, Fresno County, California",1581,96,1143,103,438,92
6019005513,"Census Tract 55.13, Fresno County, California",863,65,593,101,270,93
6019005514,"Census Tract 55.14, Fresno County, California",1233,68,954,73,279,71
6019005515,"Census Tract 55.15, Fresno County, California",638,46,554,80,84,66
6019005602,"Census Tract 56.02, Fresno County, California",2157,159,640,153,1517,217
6019005604,"Census Tract 56.04, Fresno County, California",3110,212,1134,146,1976,218
6019005605,"Census Tract 56.05, Fresno County, California",528,16,421,59,107,55
6019005606,"Census Tract 56.06, Fresno County, California",1349,74,910,87,439,98
6019005701,"Census Tract 57.01, Fresno County, California",1377,86,829,127,548,126
6019005702,"Census Tract 57.02, Fresno County, California",1754,103,1541,129,213,100
6019005703,"Census Tract 57.03, Fresno County, California",2038,90,1788,108,250,100
6019005704,"Census Tract 57.04, Fresno County, California",1701,122,1061,151,640,134
6019005801,"Census Tract 58.01, Fresno County, California",1766,52,1263,101,503,96
6019005802,"Census Tract 58.02, Fresno County, California",1397,73,1194,107,203,86
6019005803,"Census Tract 58.03, Fresno County, California",2756,141,2272,186,484,173
6019005902,"Census Tract 59.02, Fresno County, California",2940,194,2264,235,676,174
6019005903,"Census Tract 59.03, Fresno County, California",3463,189,2940,198,523,146
6019005904,"Census Tract 59.04, Fresno County, California",1011,107,782,91,229,103
6019006000,"Census Tract 60, Fresno County, California",2857,240,1669,233,1188,232
6019006100,"Census Tract 61, Fresno County, California",1974,162,1156,143,818,134
6019006200,"Census Tract 62, Fresno County, California",2579,158,1694,232,885,199
6019006300,"Census Tract 63, Fresno County, California",2014,147,1318,155,696,156
6019006401,"Census Tract 64.01, Fresno County, California",3425,222,2836,212,589,175
6019006402,"Census Tract 64.02, Fresno County, California",1201,109,872,89,329,100
6019006403,"Census Tract 64.03, Fresno County, California",2232,182,1801,195,431,131
6019006500,"Census Tract 65, Fresno County, California",2538,176,1012,164,1526,205
6019006601,"Census Tract 66.01, Fresno County, California",2255,224,1310,190,945,161
6019006602,"Census Tract 66.02, Fresno County, California",1412,158,698,119,714,139
6019006700,"Census Tract 67, Fresno County, California",1611,181,1124,175,487,128
6019006801,"Census Tract 68.01, Fresno County, California",2849,236,1477,255,1372,230
6019006802,"Census Tract 68.02, Fresno County, California",1003,120,584,99,419,119
6019006900,"Census Tract 69, Fresno County, California",839,73,505,87,334,87
6019007002,"Census Tract 70.02, Fresno County, California",1408,102,615,102,793,124
6019007003,"Census Tract 70.03, Fresno County, California",2173,110,1636,142,537,138
6019007004,"Census Tract 70.04, Fresno County, California",1841,129,1384,137,457,110
6019007100,"Census Tract 71, Fresno County, California",1976,115,1086,138,890,151
6019007201,"Census Tract 72.01, Fresno County, California",2326,191,1289,175,1037,171
6019007202,"Census Tract 72.02, Fresno County, California",1574,122,1125,127,449,129
6019007300,"Census Tract 73, Fresno County, California",1331,89,819,136,512,121
6019007400,"Census Tract 74, Fresno County, California",877,80,561,126,316,116
6019007500,"Census Tract 75, Fresno County, California",1258,110,677,103,581,111
6019007600,"Census Tract 76, Fresno County, California",1221,56,482,56,739,66
6019007700,"Census Tract 77, Fresno County, California",1489,102,738,130,751,127
6019007800,"Census Tract 78, Fresno County, California",2120,185,400,123,1720,193
6019007900,"Census Tract 79, Fresno County, California",780,76,428,74,352,88
6019008000,"Census Tract 80, Fresno County, California",1805,163,999,171,806,136
6019008100,"Census Tract 81, Fresno County, California",1804,145,912,128,892,129
6019008200,"Census Tract 82, Fresno County, California",1498,121,621,120,877,119
6019008301,"Census Tract 83.01, Fresno County, California",1294,127,622,139,672,145
6019008302,"Census Tract 83.02, Fresno County, California",1526,126,580,107,946,130
6019008401,"Census Tract 84.01, Fresno County, California",1995,184,916,138,1079,162
6019008402,"Census Tract 84.02, Fresno County, California",351,55,107,44,244,63
6021010100,"Census Tract 101, Glenn County, California",2719,211,1859,245,860,180
6021010200,"Census Tract 102, Glenn County, California",1643,125,1312,155,331,98
6021010300,"Census Tract 103, Glenn County, California",633,96,445,87,188,68
6021010400,"Census Tract 104, Glenn County, California",2935,220,2003,220,932,200
6021010501,"Census Tract 105.01, Glenn County, California",987,95,573,78,414,81
6021010502,"Census Tract 105.02, Glenn County, California",641,69,456,71,185,52
6023000100,"Census Tract 1, Humboldt County, California",1996,170,436,137,1560,195
6023000200,"Census Tract 2, Humboldt County, California",2261,140,928,154,1333,197
6023000300,"Census Tract 3, Humboldt County, California",2190,159,1356,199,834,195
6023000400,"Census Tract 4, Humboldt County, California",1509,141,1136,145,373,109
6023000500,"Census Tract 5, Humboldt County, California",1722,123,512,88,1210,122
6023000600,"Census Tract 6, Humboldt County, California",1917,156,1185,137,732,168
6023000700,"Census Tract 7, Humboldt County, California",2226,130,1239,140,987,180
6023000800,"Census Tract 8, Humboldt County, California",1825,111,1117,135,708,146
6023000900,"Census Tract 9, Humboldt County, California",2154,132,1580,127,574,147
6023001000,"Census Tract 10, Humboldt County, California",2427,239,515,113,1912,241
6023001100,"Census Tract 11, Humboldt County, California",3154,228,1317,143,1837,223
6023001200,"Census Tract 12, Humboldt County, California",2172,195,1035,140,1137,185
6023010101,"Census Tract 101.01, Humboldt County, California",730,86,477,76,253,64
6023010102,"Census Tract 101.02, Humboldt County, California",1093,135,677,129,416,123
6023010200,"Census Tract 102, Humboldt County, California",1201,101,826,92,375,70
6023010300,"Census Tract 103, Humboldt County, California",1464,98,994,99,470,106
6023010400,"Census Tract 104, Humboldt County, California",1427,108,1046,117,381,119
6023010501,"Census Tract 105.01, Humboldt County, California",2742,185,1519,163,1223,187
6023010502,"Census Tract 105.02, Humboldt County, California",2309,179,1559,220,750,201
6023010600,"Census Tract 106, Humboldt County, California",783,63,642,60,141,56
6023010700,"Census Tract 107, Humboldt County, California",2714,184,1920,190,794,210
6023010800,"Census Tract 108, Humboldt County, California",2036,110,1079,108,957,137
6023010900,"Census Tract 109, Humboldt County, California",3026,190,1953,200,1073,184
6023011000,"Census Tract 110, Humboldt County, California",1784,124,1275,135,509,114
6023011100,"Census Tract 111, Humboldt County, California",1744,138,1013,128,731,120
6023011200,"Census Tract 112, Humboldt County, California",1297,114,851,96,446,103
6023011300,"Census Tract 113, Humboldt County, California",2617,242,1754,223,863,205
6025010100,"Census Tract 101, Imperial County, California",1522,165,893,162,629,142
6025010200,"Census Tract 102, Imperial County, California",696,67,393,55,303,68
6025010300,"Census Tract 103, Imperial County, California",342,46,253,49,89,44
6025010400,"Census Tract 104, Imperial County, California",1860,113,839,148,1021,151
6025010500,"Census Tract 105, Imperial County, California",2003,161,1152,150,851,173
6025010600,"Census Tract 106, Imperial County, California",1791,192,977,152,814,185
6025010700,"Census Tract 107, Imperial County, California",1269,118,645,108,624,114
6025010800,"Census Tract 108, Imperial County, California",454,77,223,55,231,72
6025010900,"Census Tract 109, Imperial County, California",1905,164,1139,181,766,147
6025011000,"Census Tract 110, Imperial County, California",3091,189,2030,219,1061,219
6025011100,"Census Tract 111, Imperial County, California",1138,115,687,116,451,118
6025011201,"Census Tract 112.01, Imperial County, California",1761,142,1328,169,433,118
6025011202,"Census Tract 112.02, Imperial County, California",1788,119,527,115,1261,146
6025011300,"Census Tract 113, Imperial County, California",1969,144,1221,158,748,137
6025011400,"Census Tract 114, Imperial County, California",1116,102,553,107,563,129
6025011500,"Census Tract 115, Imperial County, California",1907,134,549,146,1358,169
6025011600,"Census Tract 116, Imperial County, California",2190,125,790,184,1400,198
6025011700,"Census Tract 117, Imperial County, California",1538,91,1060,124,478,98
6025011801,"Census Tract 118.01, Imperial County, California",1087,77,994,96,93,58
6025011802,"Census Tract 118.02, Imperial County, California",1850,177,879,102,971,181
6025011803,"Census Tract 118.03, Imperial County, California",1509,132,1263,154,246,85
6025011900,"Census Tract 119, Imperial County, California",2545,186,1848,217,697,190
6025012000,"Census Tract 120, Imperial County, California",3829,205,1917,262,1912,308
6025012100,"Census Tract 121, Imperial County, California",2292,170,708,147,1584,210
6025012200,"Census Tract 122, Imperial County, California",1826,131,1297,146,529,123
6025012301,"Census Tract 123.01, Imperial County, California",398,121,277,116,121,77
6025012302,"Census Tract 123.02, Imperial County, California",925,137,713,127,212,98
6025012400,"Census Tract 124, Imperial County, California",702,148,589,146,113,81
6025012500,"Census Tract 125, Imperial County, California",1102,127,517,107,585,104
6027000100,"Census Tract 1, Inyo County, California",1109,82,962,94,147,72
6027000200,"Census Tract 2, Inyo County, California",812,86,517,83,295,93
6027000300,"Census Tract 3, Inyo County, California",1097,77,899,96,198,97
6027000400,"Census Tract 4, Inyo County, California",2369,167,1115,149,1254,167
6027000500,"Census Tract 5, Inyo County, California",1093,96,751,75,342,92
6027000600,"Census Tract 6, Inyo County, California",1092,111,666,103,426,96
6027000700,"Census Tract 7, Inyo County, California",229,47,65,25,164,47
6029000101,"Census Tract 1.01, Kern County, California",3980,181,2212,217,1768,214
6029000102,"Census Tract 1.02, Kern County, California",1304,71,689,120,615,131
6029000200,"Census Tract 2, Kern County, California",2765,202,1092,176,1673,224
6029000300,"Census Tract 3, Kern County, California",1604,126,696,113,908,153
6029000400,"Census Tract 4, Kern County, California",1849,131,829,160,1020,179
6029000503,"Census Tract 5.03, Kern County, California",1445,68,1382,75,63,47
6029000504,"Census Tract 5.04, Kern County, California",1811,110,1005,99,806,124
6029000505,"Census Tract 5.05, Kern County, California",1439,31,1271,68,168,59
6029000506,"Census Tract 5.06, Kern County, California",613,37,257,74,356,78
6029000507,"Census Tract 5.07, Kern County, California",1255,80,1091,102,164,78
6029000600,"Census Tract 6, Kern County, California",2781,125,472,99,2309,162
6029000700,"Census Tract 7, Kern County, California",1928,73,1384,147,544,145
6029000800,"Census Tract 8, Kern County, California",1496,127,1117,130,379,127
6029000902,"Census Tract 9.02, Kern County, California",1255,95,842,95,413,91
6029000903,"Census Tract 9.03, Kern County, California",1417,91,813,74,604,93
6029000904,"Census Tract 9.04, Kern County, California",1478,73,934,123,544,118
6029000905,"Census Tract 9.05, Kern County, California",840,46,573,85,267,88
6029000906,"Census Tract 9.06, Kern County, California",1335,128,932,136,403,114
6029000907,"Census Tract 9.07, Kern County, California",630,77,474,89,156,75
6029000908,"Census Tract 9.08, Kern County, California",1653,88,963,101,690,120
6029000909,"Census Tract 9.09, Kern County, California",850,78,826,80,24,25
6029000910,"Census Tract 9.10, Kern County, California",3522,117,1934,183,1588,177
6029001000,"Census Tract 10, Kern County, California",2337,158,1887,195,450,137
6029001101,"Census Tract 11.01, Kern County, California",1095,99,680,85,415,99
6029001102,"Census Tract 11.02, Kern County, California",1810,93,1047,133,763,134
6029001103,"Census Tract 11.03, Kern County, California",1060,99,304,100,756,108
6029001201,"Census Tract 12.01, Kern County, California",795,52,552,75,243,74
6029001202,"Census Tract 12.02, Kern County, California",1427,127,424,86,1003,127
6029001300,"Census Tract 13, Kern County, California",2072,132,356,109,1716,136
6029001400,"Census Tract 14, Kern County, California",2107,164,816,171,1291,192
6029001500,"Census Tract 15, Kern County, California",694,75,246,79,448,106
6029001600,"Census Tract 16, Kern County, California",588,68,81,31,507,68
6029001700,"Census Tract 17, Kern County, California",1949,110,1022,119,927,148
6029001801,"Census Tract 18.01, Kern County, California",1933,155,977,147,956,187
6029001802,"Census Tract 18.02, Kern County, California",2140,120,1004,149,1136,171
6029001901,"Census Tract 19.01, Kern County, California",1298,105,707,117,591,120
6029001902,"Census Tract 19.02, Kern County, California",1758,115,625,116,1133,140
6029002000,"Census Tract 20, Kern County, California",1964,201,570,139,1394,219
6029002100,"Census Tract 21, Kern County, California",879,79,454,103,425,118
6029002200,"Census Tract 22, Kern County, California",1551,97,572,110,979,132
6029002301,"Census Tract 23.01, Kern County, California",2384,188,1596,206,788,179
6029002302,"Census Tract 23.02, Kern County, California",777,76,438,98,339,94
6029002400,"Census Tract 24, Kern County, California",1184,106,798,143,386,103
6029002500,"Census Tract 25, Kern County, California",2100,143,995,148,1105,141
6029002600,"Census Tract 26, Kern County, California",953,96,511,115,442,136
6029002700,"Census Tract 27, Kern County, California",1677,150,1124,139,553,157
6029002804,"Census Tract 28.04, Kern County, California",1528,77,1031,105,497,109
6029002806,"Census Tract 28.06, Kern County, California",898,94,355,77,543,107
6029002807,"Census Tract 28.07, Kern County, California",1365,89,1246,101,119,67
6029002808,"Census Tract 28.08, Kern County, California",2850,146,1817,160,1033,178
6029002811,"Census Tract 28.11, Kern County, California",1364,81,1320,77,44,35
6029002812,"Census Tract 28.12, Kern County, California",2112,115,571,127,1541,166
6029002813,"Census Tract 28.13, Kern County, California",1586,114,448,110,1138,151
6029002814,"Census Tract 28.14, Kern County, California",1475,107,535,76,940,129
6029002815,"Census Tract 28.15, Kern County, California",1440,68,664,94,776,111
6029002816,"Census Tract 28.16, Kern County, California",1754,84,995,116,759,140
6029002817,"Census Tract 28.17, Kern County, California",1736,82,702,112,1034,135
6029002818,"Census Tract 28.18, Kern County, California",1473,101,924,109,549,139
6029002819,"Census Tract 28.19, Kern County, California",1681,83,828,124,853,146
6029002820,"Census Tract 28.20, Kern County, California",1811,87,1694,98,117,61
6029002821,"Census Tract 28.21, Kern County, California",1649,72,1044,139,605,121
6029002900,"Census Tract 29, Kern County, California",2412,129,941,139,1471,200
6029003000,"Census Tract 30, Kern County, California",2052,127,1143,152,909,149
6029003103,"Census Tract 31.03, Kern County, California",948,88,576,109,372,99
6029003112,"Census Tract 31.12, Kern County, California",1906,76,1013,133,893,117
6029003113,"Census Tract 31.13, Kern County, California",1423,79,808,130,615,131
6029003114,"Census Tract 31.14, Kern County, California",2229,74,1399,189,830,185
6029003115,"Census Tract 31.15, Kern County, California",1515,52,978,106,537,109
6029003121,"Census Tract 31.21, Kern County, California",2230,197,1123,231,1107,244
6029003122,"Census Tract 31.22, Kern County, California",2143,94,1687,164,456,130
6029003123,"Census Tract 31.23, Kern County, California",2628,163,2101,165,527,131
6029003124,"Census Tract 31.24, Kern County, California",1678,65,1451,123,227,123
6029003201,"Census Tract 32.01, Kern County, California",4247,194,3042,266,1205,247
6029003202,"Census Tract 32.02, Kern County, California",3488,215,2535,218,953,235
6029003203,"Census Tract 32.03, Kern County, California",750,62,674,87,76,55
6029003204,"Census Tract 32.04, Kern County, California",2170,145,1660,172,510,142
6029003302,"Census Tract 33.02, Kern County, California",2822,271,2276,294,546,186
6029003303,"Census Tract 33.03, Kern County, California",525,48,378,58,147,50
6029003304,"Census Tract 33.04, Kern County, California",841,77,597,85,244,79
6029003400,"Census Tract 34, Kern County, California",1256,148,748,120,508,136
6029003500,"Census Tract 35, Kern County, California",2270,210,1519,235,751,190
6029003600,"Census Tract 36, Kern County, California",1397,131,790,150,607,153
6029003700,"Census Tract 37, Kern County, California",1039,64,685,65,354,67
6029003803,"Census Tract 38.03, Kern County, California",1292,146,1223,131,69,56
6029003804,"Census Tract 38.04, Kern County, California",3301,155,2606,177,695,161
6029003805,"Census Tract 38.05, Kern County, California",2706,114,2394,143,312,119
6029003806,"Census Tract 38.06, Kern County, California",1316,86,1211,89,105,61
6029003807,"Census Tract 38.07, Kern County, California",1231,61,942,138,289,130
6029003808,"Census Tract 38.08, Kern County, California",1749,93,1110,134,639,138
6029003809,"Census Tract 38.09, Kern County, California",3150,164,2810,153,340,121
6029003810,"Census Tract 38.10, Kern County, California",880,55,803,77,77,60
6029003811,"Census Tract 38.11, Kern County, California",884,68,574,92,310,100
6029003812,"Census Tract 38.12, Kern County, California",1709,88,964,99,745,99
6029003813,"Census Tract 38.13, Kern County, California",2349,125,2022,158,327,107
6029003900,"Census Tract 39, Kern County, California",183,65,65,40,118,58
6029004000,"Census Tract 40, Kern County, California",1480,99,889,118,591,138
6029004101,"Census Tract 41.01, Kern County, California",1407,100,855,114,552,116
6029004102,"Census Tract 41.02, Kern County, California",1367,94,730,115,637,112
6029004200,"Census Tract 42, Kern County, California",364,33,178,33,186,39
6029004301,"Census Tract 43.01, Kern County, California",1666,123,920,151,746,142
6029004302,"Census Tract 43.02, Kern County, California",0,132,0,132,0,132
6029004401,"Census Tract 44.01, Kern County, California",2038,161,1325,133,713,151
6029004402,"Census Tract 44.02, Kern County, California",1441,107,451,115,990,141
6029004500,"Census Tract 45, Kern County, California",803,61,298,54,505,69
6029004601,"Census Tract 46.01, Kern County, California",28,24,0,132,28,24
6029004602,"Census Tract 46.02, Kern County, California",2347,141,1702,153,645,139
6029004700,"Census Tract 47, Kern County, California",2680,167,1519,211,1161,207
6029004800,"Census Tract 48, Kern County, California",2191,180,884,173,1307,194
6029004901,"Census Tract 49.01, Kern County, California",1426,106,584,120,842,122
6029004902,"Census Tract 49.02, Kern County, California",2066,109,1517,163,549,163
6029005000,"Census Tract 50, Kern County, California",2848,181,1411,211,1437,197
6029005103,"Census Tract 51.03, Kern County, California",1136,76,978,104,158,72
6029005104,"Census Tract 51.04, Kern County, California",643,89,493,90,150,60
6029005201,"Census Tract 52.01, Kern County, California",2549,255,1935,241,614,194
6029005202,"Census Tract 52.02, Kern County, California",4804,323,3720,332,1084,213
6029005300,"Census Tract 53, Kern County, California",603,76,44,27,559,83
6029005401,"Census Tract 54.01, Kern County, California",2360,163,1526,163,834,170
6029005402,"Census Tract 54.02, Kern County, California",1677,117,1206,133,471,123
6029005403,"Census Tract 54.03, Kern County, California",2706,163,1866,212,840,211
6029005404,"Census Tract 54.04, Kern County, California",2397,175,1404,164,993,205
6029005501,"Census Tract 55.01, Kern County, California",2325,192,1979,204,346,169
6029005503,"Census Tract 55.03, Kern County, California",985,129,666,111,319,112
6029005504,"Census Tract 55.04, Kern County, California",40,63,40,63,0,132
6029005505,"Census Tract 55.05, Kern County, California",4547,322,2873,363,1674,257
6029005506,"Census Tract 55.06, Kern County, California",1858,140,1346,183,512,156
6029005600,"Census Tract 56, Kern County, California",889,81,591,85,298,98
6029005700,"Census Tract 57, Kern County, California",807,177,75,93,732,175
6029005800,"Census Tract 58, Kern County, California",4125,226,2619,277,1506,248
6029005900,"Census Tract 59, Kern County, California",1274,109,649,101,625,119
6029006002,"Census Tract 60.02, Kern County, California",0,132,0,132,0,132
6029006003,"Census Tract 60.03, Kern County, California",1780,169,1088,166,692,173
6029006004,"Census Tract 60.04, Kern County, California",584,75,477,84,107,53
6029006005,"Census Tract 60.05, Kern County, California",5335,311,4604,306,731,244
6029006100,"Census Tract 61, Kern County, California",1970,410,1337,297,633,180
6029006201,"Census Tract 62.01, Kern County, California",785,89,434,107,351,107
6029006202,"Census Tract 62.02, Kern County, California",742,66,458,74,284,64
6029006301,"Census Tract 63.01, Kern County, California",854,81,572,102,282,78
6029006302,"Census Tract 63.02, Kern County, California",2140,149,1020,168,1120,158
6029006401,"Census Tract 64.01, Kern County, California",1962,110,1112,154,850,157
6029006402,"Census Tract 64.02, Kern County, California",2025,120,959,142,1066,157
6031000100,"Census Tract 1, Kings County, California",1186,106,784,110,402,84
6031000200,"Census Tract 2, Kings County, California",669,72,454,71,215,53
6031000300,"Census Tract 3, Kings County, California",1299,220,0,132,1299,220
6031000402,"Census Tract 4.02, Kings County, California",1557,122,1106,151,451,142
6031000403,"Census Tract 4.03, Kings County, California",1781,126,1014,161,767,148
6031000404,"Census Tract 4.04, Kings County, California",2846,190,1826,224,1020,200
6031000405,"Census Tract 4.05, Kings County, California",1891,170,787,156,1104,195
6031000500,"Census Tract 5, Kings County, California",1511,135,1062,145,449,114
6031000601,"Census Tract 6.01, Kings County, California",2081,155,1550,147,531,152
6031000602,"Census Tract 6.02, Kings County, California",2459,196,1290,237,1169,239
6031000701,"Census Tract 7.01, Kings County, California",1881,110,1435,127,446,110
6031000702,"Census Tract 7.02, Kings County, California",1425,98,980,125,445,109
6031000800,"Census Tract 8, Kings County, California",1469,109,846,127,623,101
6031000900,"Census Tract 9, Kings County, California",2629,217,936,145,1693,230
6031001001,"Census Tract 10.01, Kings County, California",1320,94,1032,84,288,89
6031001002,"Census Tract 10.02, Kings County, California",1404,168,591,180,813,198
6031001003,"Census Tract 10.03, Kings County, California",1369,122,881,115,488,141
6031001100,"Census Tract 11, Kings County, California",1643,127,742,125,901,119
6031001200,"Census Tract 12, Kings County, California",761,74,444,64,317,58
6031001300,"Census Tract 13, Kings County, California",937,119,356,88,581,143
6031001400,"Census Tract 14, Kings County, California",1351,129,947,156,404,107
6031001500,"Census Tract 15, Kings County, California",1303,123,835,137,468,121
6031001601,"Census Tract 16.01, Kings County, California",928,93,575,107,353,109
6031001602,"Census Tract 16.02, Kings County, California",0,132,0,132,0,132
6031001701,"Census Tract 17.01, Kings County, California",3563,343,1287,240,2276,297
6031001702,"Census Tract 17.02, Kings County, California",0,132,0,132,0,132
6033000100,"Census Tract 1, Lake County, California",1135,180,963,141,172,114
6033000300,"Census Tract 3, Lake County, California",1588,138,1246,130,342,119
6033000400,"Census Tract 4, Lake County, California",2479,252,1556,289,923,242
6033000500,"Census Tract 5, Lake County, California",2235,273,1626,218,609,183
6033000600,"Census Tract 6, Lake County, California",1737,234,1316,215,421,152
6033000700,"Census Tract 7, Lake County, California",3224,346,1565,278,1659,326
6033000800,"Census Tract 8, Lake County, California",2948,311,1375,254,1573,252
6033000900,"Census Tract 9, Lake County, California",2342,235,1842,221,500,155
6033001000,"Census Tract 10, Lake County, California",2231,177,1668,190,563,170
6033001100,"Census Tract 11, Lake County, California",1387,203,1077,190,310,138
6033001200,"Census Tract 12, Lake County, California",1166,173,873,160,293,122
6033001300,"Census Tract 13, Lake County, California",2688,232,2109,208,579,201
6035040100,"Census Tract 401, Lassen County, California",623,101,521,89,102,48
6035040200,"Census Tract 402, Lassen County, California",1221,146,928,137,293,106
6035040301,"Census Tract 403.01, Lassen County, California",3871,250,2044,265,1827,265
6035040302,"Census Tract 403.02, Lassen County, California",1759,162,1337,153,422,139
6035040400,"Census Tract 404, Lassen County, California",467,95,358,71,109,65
6035040500,"Census Tract 405, Lassen County, California",1267,149,1056,156,211,111
6035040600,"Census Tract 406, Lassen County, California",1080,219,740,156,340,169
6037101110,"Census Tract 1011.10, Los Angeles County, California",1649,75,840,120,809,118
6037101120,"Census Tract 1011.20, Los Angeles County, California",1331,50,1195,96,136,83
6037101210,"Census Tract 1012.10, Los Angeles County, California",2230,81,432,147,1798,171
6037101220,"Census Tract 1012.20, Los Angeles County, California",1237,78,516,116,721,116
6037101300,"Census Tract 1013, Los Angeles County, California",1407,75,1246,98,161,74
6037101400,"Census Tract 1014, Los Angeles County, California",1329,96,964,116,365,115
6037102101,"Census Tract 1021.01, Los Angeles County, California",929,86,681,85,248,74
6037102102,"Census Tract 1021.02, Los Angeles County, California",2440,74,1988,159,452,157
6037103101,"Census Tract 1031.01, Los Angeles County, California",923,53,828,59,95,54
6037103102,"Census Tract 1031.02, Los Angeles County, California",1599,89,1162,126,437,109
6037103200,"Census Tract 1032, Los Angeles County, California",2089,43,1293,144,796,152
6037103300,"Census Tract 1033, Los Angeles County, California",1467,54,1270,94,197,81
6037103400,"Census Tract 1034, Los Angeles County, California",2458,130,1819,159,639,148
6037104103,"Census Tract 1041.03, Los Angeles County, California",723,86,668,92,55,45
6037104104,"Census Tract 1041.04, Los Angeles County, California",947,44,775,106,172,99
6037104105,"Census Tract 1041.05, Los Angeles County, California",1392,95,627,111,765,120
6037104106,"Census Tract 1041.06, Los Angeles County, California",1321,63,591,111,730,122
6037104107,"Census Tract 1041.07, Los Angeles County, California",220,77,157,65,63,65
6037104201,"Census Tract 1042.01, Los Angeles County, California",946,21,689,97,257,93
6037104202,"Census Tract 1042.02, Los Angeles County, California",1536,180,909,138,627,141
6037104310,"Census Tract 1043.10, Los Angeles County, California",531,51,413,70,118,67
6037104320,"Census Tract 1043.20, Los Angeles County, California",1179,78,765,105,414,118
6037104401,"Census Tract 1044.01, Los Angeles County, California",848,68,593,91,255,79
6037104402,"Census Tract 1044.02, Los Angeles County, California",887,137,388,98,499,135
6037104500,"Census Tract 1045, Los Angeles County, California",924,64,621,65,303,86
6037104610,"Census Tract 1046.10, Los Angeles County, California",626,74,388,87,238,97
6037104620,"Census Tract 1046.20, Los Angeles County, California",705,40,476,73,229,69
6037104701,"Census Tract 1047.01, Los Angeles County, California",886,47,219,77,667,88
6037104702,"Census Tract 1047.02, Los Angeles County, California",1597,90,824,111,773,131
6037104810,"Census Tract 1048.10, Los Angeles County, California",974,85,622,111,352,133
6037104820,"Census Tract 1048.20, Los Angeles County, California",1180,75,475,94,705,98
6037106010,"Census Tract 1060.10, Los Angeles County, California",1372,51,986,103,386,89
6037106020,"Census Tract 1060.20, Los Angeles County, California",1443,138,1155,133,288,98
6037106111,"Census Tract 1061.11, Los Angeles County, California",1494,96,1261,131,233,96
6037106112,"Census Tract 1061.12, Los Angeles County, California",1522,56,1387,81,135,62
6037106113,"Census Tract 1061.13, Los Angeles County, California",859,45,748,67,111,53
6037106114,"Census Tract 1061.14, Los Angeles County, California",1414,98,728,133,686,138
6037106402,"Census Tract 1064.02, Los Angeles County, California",2215,127,1769,188,446,169
6037106403,"Census Tract 1064.03, Los Angeles County, California",756,96,637,107,119,71
6037106404,"Census Tract 1064.04, Los Angeles County, California",1436,57,499,96,937,106
6037106510,"Census Tract 1065.10, Los Angeles County, California",1143,72,912,90,231,91
6037106520,"Census Tract 1065.20, Los Angeles County, California",1406,79,1044,143,362,122
6037106602,"Census Tract 1066.02, Los Angeles County, California",1989,58,1864,76,125,54
6037106603,"Census Tract 1066.03, Los Angeles County, California",990,32,990,32,0,132
6037106604,"Census Tract 1066.04, Los Angeles County, California",1353,76,742,138,611,138
6037106605,"Census Tract 1066.05, Los Angeles County, California",1428,71,983,95,445,108
6037106606,"Census Tract 1066.06, Los Angeles County, California",0,132,0,132,0,132
6037106641,"Census Tract 1066.41, Los Angeles County, California",716,59,652,76,64,44
6037106642,"Census Tract 1066.42, Los Angeles County, California",965,67,889,84,76,72
6037106643,"Census Tract 1066.43, Los Angeles County, California",1252,57,1200,77,52,53
6037107010,"Census Tract 1070.10, Los Angeles County, California",642,75,448,100,194,82
6037107020,"Census Tract 1070.20, Los Angeles County, California",1218,70,946,110,272,97
6037108101,"Census Tract 1081.01, Los Angeles County, California",794,15,770,35,24,31
6037108102,"Census Tract 1081.02, Los Angeles County, California",1221,69,1007,94,214,86
6037108103,"Census Tract 1081.03, Los Angeles County, California",1058,27,1008,58,50,55
6037108104,"Census Tract 1081.04, Los Angeles County, California",547,56,531,65,16,24
6037108200,"Census Tract 1082, Los Angeles County, California",2967,127,2550,171,417,136
6037109100,"Census Tract 1091, Los Angeles County, California",647,17,526,72,121,66
6037109200,"Census Tract 1092, Los Angeles County, California",878,53,789,70,89,56
6037109300,"Census Tract 1093, Los Angeles County, California",1129,51,1049,80,80,64
6037109400,"Census Tract 1094, Los Angeles County, California",1387,77,1113,123,274,121
6037109500,"Census Tract 1095, Los Angeles County, California",776,36,534,91,242,88
6037109601,"Census Tract 1096.01, Los Angeles County, California",920,52,758,94,162,87
6037109602,"Census Tract 1096.02, Los Angeles County, California",1316,73,1054,108,262,102
6037109700,"Census Tract 1097, Los Angeles County, California",1430,24,1148,101,282,96
6037109800,"Census Tract 1098, Los Angeles County, California",1817,49,1290,117,527,107
6037111100,"Census Tract 1111, Los Angeles County, California",1651,73,1421,122,230,102
6037111201,"Census Tract 1112.01, Los Angeles County, California",833,29,782,51,51,44
6037111202,"Census Tract 1112.02, Los Angeles County, California",1652,93,1186,105,466,120
6037111203,"Census Tract 1112.03, Los Angeles County, California",2202,133,2102,158,100,96
6037111204,"Census Tract 1112.04, Los Angeles County, California",1887,71,1861,75,26,25
6037111301,"Census Tract 1113.01, Los Angeles County, California",2640,133,937,169,1703,190
6037111302,"Census Tract 1113.02, Los Angeles County, California",2230,97,1157,131,1073,154
6037111400,"Census Tract 1114, Los Angeles County, California",2639,114,1272,167,1367,194
6037113100,"Census Tract 1131, Los Angeles County, California",2015,78,1875,122,140,109
6037113202,"Census Tract 1132.02, Los Angeles County, California",1935,79,1448,125,487,108
6037113211,"Census Tract 1132.11, Los Angeles County, California",1452,81,1306,81,146,60
6037113212,"Census Tract 1132.12, Los Angeles County, California",1127,34,751,114,376,106
6037113213,"Census Tract 1132.13, Los Angeles County, California",1688,33,1105,131,583,130
6037113231,"Census Tract 1132.31, Los Angeles County, California",789,35,645,63,144,69
6037113232,"Census Tract 1132.32, Los Angeles County, California",1344,46,1174,93,170,86
6037113233,"Census Tract 1132.33, Los Angeles County, California",2223,132,590,154,1633,183
6037113234,"Census Tract 1132.34, Los Angeles County, California",1466,82,787,121,679,129
6037113301,"Census Tract 1133.01, Los Angeles County, California",672,49,615,58,57,59
6037113303,"Census Tract 1133.03, Los Angeles County, California",1392,53,1211,82,181,77
6037113321,"Census Tract 1133.21, Los Angeles County, California",2459,51,827,129,1632,132
6037113322,"Census Tract 1133.22, Los Angeles County, California",1347,36,1241,78,106,75
6037113401,"Census Tract 1134.01, Los Angeles County, California",1533,96,1161,141,372,125
6037113421,"Census Tract 1134.21, Los Angeles County, California",1980,112,442,114,1538,152
6037113422,"Census Tract 1134.22, Los Angeles County, California",2059,109,1260,156,799,170
6037115101,"Census Tract 1151.01, Los Angeles County, California",1710,45,1594,86,116,77
6037115102,"Census Tract 1151.02, Los Angeles County, California",1350,87,383,100,967,123
6037115201,"Census Tract 1152.01, Los Angeles County, California",2592,117,703,160,1889,198
6037115202,"Census Tract 1152.02, Los Angeles County, California",1801,97,787,113,1014,146
6037115301,"Census Tract 1153.01, Los Angeles County, California",1539,76,895,92,644,103
6037115302,"Census Tract 1153.02, Los Angeles County, California",1054,48,330,69,724,80
6037115401,"Census Tract 1154.01, Los Angeles County, California",2021,84,805,112,1216,126
6037115402,"Census Tract 1154.02, Los Angeles County, California",1770,107,618,92,1152,124
6037117100,"Census Tract 1171, Los Angeles County, California",2074,82,1453,162,621,164
6037117200,"Census Tract 1172, Los Angeles County, California",1930,60,1161,120,769,123
6037117301,"Census Tract 1173.01, Los Angeles County, California",1237,21,1102,82,135,78
6037117302,"Census Tract 1173.02, Los Angeles County, California",1676,74,1404,84,272,69
6037117303,"Census Tract 1173.03, Los Angeles County, California",1021,34,832,91,189,89
6037117404,"Census Tract 1174.04, Los Angeles County, California",1303,41,1105,75,198,69
6037117405,"Census Tract 1174.05, Los Angeles County, California",737,63,64,53,673,79
6037117406,"Census Tract 1174.06, Los Angeles County, California",1694,88,195,109,1499,133
6037117510,"Census Tract 1175.10, Los Angeles County, California",1128,35,228,67,900,70
6037117520,"Census Tract 1175.20, Los Angeles County, California",865,68,105,59,760,81
6037117530,"Census Tract 1175.30, Los Angeles County, California",1522,52,505,90,1017,99
6037119000,"Census Tract 1190, Los Angeles County, California",1405,48,1087,124,318,117
6037119100,"Census Tract 1191, Los Angeles County, California",1092,62,890,92,202,86
6037119200,"Census Tract 1192, Los Angeles County, California",945,56,487,104,458,105
6037119310,"Census Tract 1193.10, Los Angeles County, California",932,49,685,91,247,90
6037119320,"Census Tract 1193.20, Los Angeles County, California",927,85,220,73,707,99
6037119330,"Census Tract 1193.30, Los Angeles County, California",1523,49,617,114,906,116
6037119340,"Census Tract 1193.40, Los Angeles County, California",1866,77,440,137,1426,151
6037119400,"Census Tract 1194, Los Angeles County, California",1601,33,1267,100,334,103
6037119700,"Census Tract 1197, Los Angeles County, California",1228,65,1045,85,183,64
6037119800,"Census Tract 1198, Los Angeles County, California",1400,55,1093,112,307,111
6037119900,"Census Tract 1199, Los Angeles County, California",1623,55,1192,122,431,114
6037120010,"Census Tract 1200.10, Los Angeles County, California",876,70,523,87,353,89
6037120020,"Census Tract 1200.20, Los Angeles County, California",1126,33,276,68,850,74
6037120030,"Census Tract 1200.30, Los Angeles County, California",685,56,81,72,604,90
6037120101,"Census Tract 1201.01, Los Angeles County, California",2189,69,432,128,1757,125
6037120102,"Census Tract 1201.02, Los Angeles County, California",2847,106,548,118,2299,162
6037120300,"Census Tract 1203, Los Angeles County, California",1362,93,932,129,430,128
6037120400,"Census Tract 1204, Los Angeles County, California",1885,77,500,107,1385,126
6037121010,"Census Tract 1210.10, Los Angeles County, California",1214,66,870,110,344,114
6037121020,"Census Tract 1210.20, Los Angeles County, California",978,63,562,99,416,104
6037121100,"Census Tract 1211, Los Angeles County, California",1295,84,963,94,332,106
6037121210,"Census Tract 1212.10, Los Angeles County, California",1325,54,669,91,656,104
6037121220,"Census Tract 1212.20, Los Angeles County, California",946,51,745,74,201,75
6037121600,"Census Tract 1216, Los Angeles County, California",821,40,728,64,93,64
6037121800,"Census Tract 1218, Los Angeles County, California",1785,74,906,135,879,138
6037121900,"Census Tract 1219, Los Angeles County, California",997,72,610,96,387,105
6037122000,"Census Tract 1220, Los Angeles County, California",1443,73,992,119,451,134
6037122110,"Census Tract 1221.10, Los Angeles County, California",1326,70,402,109,924,130
6037122120,"Census Tract 1221.20, Los Angeles County, California",1072,48,642,91,430,93
6037122200,"Census Tract 1222, Los Angeles County, California",1481,87,560,106,921,129
6037122410,"Census Tract 1224.10, Los Angeles County, California",1117,52,49,37,1068,70
6037122420,"Census Tract 1224.20, Los Angeles County, California",1323,51,533,105,790,119
6037123010,"Census Tract 1230.10, Los Angeles County, California",1031,62,334,96,697,109
6037123020,"Census Tract 1230.20, Los Angeles County, California",709,52,478,80,231,72
6037123103,"Census Tract 1231.03, Los Angeles County, California",1476,77,572,86,904,94
6037123104,"Census Tract 1231.04, Los Angeles County, California",1667,23,374,110,1293,112
6037123203,"Census Tract 1232.03, Los Angeles County, California",1041,66,127,52,914,77
6037123204,"Census Tract 1232.04, Los Angeles County, California",927,75,109,55,818,82
6037123205,"Census Tract 1232.05, Los Angeles County, California",735,43,91,52,644,70
6037123206,"Census Tract 1232.06, Los Angeles County, California",810,72,139,53,671,69
6037123301,"Census Tract 1233.01, Los Angeles County, California",1555,42,618,85,937,97
6037123303,"Census Tract 1233.03, Los Angeles County, California",862,63,278,69,584,91
6037123304,"Census Tract 1233.04, Los Angeles County, California",1568,95,310,162,1258,170
6037123410,"Census Tract 1234.10, Los Angeles County, California",1248,70,351,97,897,102
6037123420,"Census Tract 1234.20, Los Angeles County, California",1324,80,455,113,869,113
6037123510,"Census Tract 1235.10, Los Angeles County, California",1402,91,401,81,1001,121
6037123520,"Census Tract 1235.20, Los Angeles County, California",945,63,297,82,648,92
6037123601,"Census Tract 1236.01, Los Angeles County, California",1865,67,778,126,1087,129
6037123602,"Census Tract 1236.02, Los Angeles County, California",1306,63,621,100,685,118
6037123700,"Census Tract 1237, Los Angeles County, California",1517,47,707,94,810,111
6037123800,"Census Tract 1238, Los Angeles County, California",2336,109,780,147,1556,181
6037123900,"Census Tract 1239, Los Angeles County, California",2484,113,708,128,1776,161
6037124000,"Census Tract 1240, Los Angeles County, California",1985,111,1229,158,756,157
6037124101,"Census Tract 1241.01, Los Angeles County, California",2549,91,567,114,1982,139
6037124102,"Census Tract 1241.02, Los Angeles County, California",1196,148,429,84,767,154
6037124201,"Census Tract 1242.01, Los Angeles County, California",987,104,564,114,423,107
6037124202,"Census Tract 1242.02, Los Angeles County, California",1789,99,372,103,1417,125
6037124300,"Census Tract 1243, Los Angeles County, California",1361,83,346,96,1015,124
6037124400,"Census Tract 1244, Los Angeles County, California",1576,147,851,101,725,137
6037124500,"Census Tract 1245, Los Angeles County, California",1156,70,625,68,531,88
6037124600,"Census Tract 1246, Los Angeles County, California",1901,120,976,129,925,156
6037124700,"Census Tract 1247, Los Angeles County, California",2006,140,1066,154,940,188
6037124901,"Census Tract 1249.01, Los Angeles County, California",3135,104,435,123,2700,151
6037125100,"Census Tract 1251, Los Angeles County, California",2801,161,702,166,2099,205
6037125200,"Census Tract 1252, Los Angeles County, California",1784,72,592,111,1192,130
6037125310,"Census Tract 1253.10, Los Angeles County, California",1357,109,366,86,991,131
6037125320,"Census Tract 1253.20, Los Angeles County, California",1979,114,60,38,1919,119
6037125400,"Census Tract 1254, Los Angeles County, California",3969,127,577,127,3392,184
6037125500,"Census Tract 1255, Los Angeles County, California",3332,160,566,149,2766,202
6037125600,"Census Tract 1256, Los Angeles County, California",1227,63,543,103,684,96
6037127101,"Census Tract 1271.01, Los Angeles County, California",2298,126,574,152,1724,192
6037127102,"Census Tract 1271.02, Los Angeles County, California",1456,74,526,105,930,112
6037127210,"Census Tract 1272.10, Los Angeles County, California",1713,123,624,122,1089,143
6037127220,"Census Tract 1272.20, Los Angeles County, California",1639,69,423,97,1216,116
6037127300,"Census Tract 1273, Los Angeles County, California",1613,82,461,97,1152,115
6037127400,"Census Tract 1274, Los Angeles County, California",1229,78,371,95,858,101
6037127510,"Census Tract 1275.10, Los Angeles County, California",1612,117,897,160,715,151
6037127520,"Census Tract 1275.20, Los Angeles County, California",860,102,41,29,819,102
6037127601,"Census Tract 1276.01, Los Angeles County, California",2080,66,405,111,1675,122
6037127602,"Census Tract 1276.02, Los Angeles County, California",2089,77,619,103,1470,127
6037127710,"Census Tract 1277.10, Los Angeles County, California",2434,176,710,150,1724,197
6037127801,"Census Tract 1278.01, Los Angeles County, California",2698,103,753,134,1945,167
6037127802,"Census Tract 1278.02, Los Angeles County, California",2171,115,545,121,1626,147
6037127910,"Census Tract 1279.10, Los Angeles County, California",1487,62,274,95,1213,125
6037127920,"Census Tract 1279.20, Los Angeles County, California",1244,63,449,99,795,103
6037128100,"Census Tract 1281, Los Angeles County, California",2564,130,632,134,1932,176
6037128210,"Census Tract 1282.10, Los Angeles County, California",1427,84,27,26,1400,92
6037128220,"Census Tract 1282.20, Los Angeles County, California",1172,33,391,83,781,88
6037128302,"Census Tract 1283.02, Los Angeles County, California",1438,58,214,70,1224,97
6037128303,"Census Tract 1283.03, Los Angeles County, California",1059,64,43,37,1016,71
6037128400,"Census Tract 1284, Los Angeles County, California",1736,59,815,108,921,99
6037128500,"Census Tract 1285, Los Angeles County, California",2354,157,951,178,1403,195
6037128600,"Census Tract 1286, Los Angeles County, California",2387,120,788,128,1599,164
6037128702,"Census Tract 1287.02, Los Angeles County, California",2705,107,1107,221,1598,190
6037128800,"Census Tract 1288, Los Angeles County, California",3716,156,1069,153,2647,194
6037128910,"Census Tract 1289.10, Los Angeles County, California",1844,61,800,117,1044,137
6037131010,"Census Tract 1310.10, Los Angeles County, California",1901,84,526,92,1375,110
6037131020,"Census Tract 1310.20, Los Angeles County, California",1562,92,679,122,883,144
6037131100,"Census Tract 1311, Los Angeles County, California",986,70,848,97,138,85
6037131200,"Census Tract 1312, Los Angeles County, California",1123,18,1013,78,110,75
6037131300,"Census Tract 1313, Los Angeles County, California",1212,45,1017,82,195,80
6037131400,"Census Tract 1314, Los Angeles County, California",1734,88,965,121,769,134
6037131600,"Census Tract 1316, Los Angeles County, California",1335,80,1050,121,285,114
6037131700,"Census Tract 1317, Los Angeles County, California",2720,120,1455,158,1265,157
6037131800,"Census Tract 1318, Los Angeles County, California",1489,67,889,134,600,138
6037131900,"Census Tract 1319, Los Angeles County, California",1298,83,1159,97,139,85
6037132000,"Census Tract 1320, Los Angeles County, California",2210,87,1603,160,607,140
6037132100,"Census Tract 1321, Los Angeles County, California",2097,96,973,123,1124,150
6037132300,"Census Tract 1323, Los Angeles County, California",2231,108,772,209,1459,198
6037132500,"Census Tract 1325, Los Angeles County, California",2359,115,1211,174,1148,165
6037132700,"Census Tract 1327, Los Angeles County, California",1520,52,920,104,600,105
6037132900,"Census Tract 1329, Los Angeles County, California",1316,64,782,119,534,127
6037133000,"Census Tract 1330, Los Angeles County, California",1128,102,880,101,248,97
6037133100,"Census Tract 1331, Los Angeles County, California",1776,73,913,115,863,119
6037134000,"Census Tract 1340, Los Angeles County, California",1919,80,771,111,1148,127
6037134101,"Census Tract 1341.01, Los Angeles County, California",1457,26,1154,93,303,89
6037134103,"Census Tract 1341.03, Los Angeles County, California",1267,81,822,108,445,115
6037134104,"Census Tract 1341.04, Los Angeles County, California",1235,58,708,110,527,109
6037134201,"Census Tract 1342.01, Los Angeles County, California",1134,64,775,92,359,93
6037134302,"Census Tract 1343.02, Los Angeles County, California",1269,19,1116,77,153,74
6037134303,"Census Tract 1343.03, Los Angeles County, California",1743,81,1390,153,353,139
6037134304,"Census Tract 1343.04, Los Angeles County, California",778,56,646,63,132,49
6037134305,"Census Tract 1343.05, Los Angeles County, California",1044,68,9,14,1035,70
6037134306,"Census Tract 1343.06, Los Angeles County, California",1183,89,534,102,649,106
6037134401,"Census Tract 1344.01, Los Angeles County, California",2107,94,1933,121,174,108
6037134421,"Census Tract 1344.21, Los Angeles County, California",1363,37,1283,68,80,60
6037134422,"Census Tract 1344.22, Los Angeles County, California",1554,65,1243,121,311,130
6037134510,"Census Tract 1345.10, Los Angeles County, California",1820,119,267,107,1553,151
6037134520,"Census Tract 1345.20, Los Angeles County, California",1803,71,315,88,1488,111
6037134710,"Census Tract 1347.10, Los Angeles County, California",1432,86,406,79,1026,104
6037134720,"Census Tract 1347.20, Los Angeles County, California",1485,95,935,128,550,130
6037134800,"Census Tract 1348, Los Angeles County, California",1808,58,1460,142,348,136
6037134901,"Census Tract 1349.01, Los Angeles County, California",1156,31,741,82,415,77
6037134902,"Census Tract 1349.02, Los Angeles County, California",3434,161,927,182,2507,205
6037135102,"Census Tract 1351.02, Los Angeles County, California",1073,85,943,108,130,81
6037135111,"Census Tract 1351.11, Los Angeles County, California",1122,59,692,112,430,103
6037135112,"Census Tract 1351.12, Los Angeles County, California",3441,211,659,125,2782,250
6037135201,"Census Tract 1352.01, Los Angeles County, California",790,51,708,73,82,59
6037135202,"Census Tract 1352.02, Los Angeles County, California",1453,64,1278,100,175,78
6037135203,"Census Tract 1352.03, Los Angeles County, California",2352,105,1988,160,364,141
6037137000,"Census Tract 1370, Los Angeles County, California",1669,57,1440,95,229,87
6037137102,"Census Tract 1371.02, Los Angeles County, California",2819,203,2094,236,725,210
6037137201,"Census Tract 1372.01, Los Angeles County, California",2221,170,1185,184,1036,180
6037137301,"Census Tract 1373.01, Los Angeles County, California",766,12,729,34,37,34
6037137302,"Census Tract 1373.02, Los Angeles County, California",1611,27,1488,93,123,94
6037137401,"Census Tract 1374.01, Los Angeles County, California",1834,78,1380,120,454,107
6037137402,"Census Tract 1374.02, Los Angeles County, California",1941,105,1464,104,477,109
6037137501,"Census Tract 1375.01, Los Angeles County, California",1592,105,759,100,833,131
6037137502,"Census Tract 1375.02, Los Angeles County, California",1646,64,1260,109,386,114
6037137504,"Census Tract 1375.04, Los Angeles County, California",667,42,667,42,0,132
6037138000,"Census Tract 1380, Los Angeles County, California",1798,72,1644,96,154,76
6037139000,"Census Tract 1390, Los Angeles County, California",1961,168,1050,166,911,159
6037139200,"Census Tract 1392, Los Angeles County, California",2249,145,1014,185,1235,211
6037139301,"Census Tract 1393.01, Los Angeles County, California",1560,69,1376,83,184,84
6037139302,"Census Tract 1393.02, Los Angeles County, California",1848,100,617,126,1231,129
6037139303,"Census Tract 1393.03, Los Angeles County, California",1905,102,737,125,1168,131
6037139400,"Census Tract 1394, Los Angeles County, California",2147,52,1211,129,936,132
6037139501,"Census Tract 1395.01, Los Angeles County, California",4285,162,1500,231,2785,249
6037139502,"Census Tract 1395.02, Los Angeles County, California",1205,80,746,108,459,106
6037139600,"Census Tract 1396, Los Angeles County, California",2115,115,1358,146,757,161
6037139701,"Census Tract 1397.01, Los Angeles County, California",1850,63,1672,86,178,83
6037139702,"Census Tract 1397.02, Los Angeles County, California",2187,85,2093,105,94,62
6037139703,"Census Tract 1397.03, Los Angeles County, California",1046,48,935,76,111,65
6037139801,"Census Tract 1398.01, Los Angeles County, California",1153,92,1089,96,64,47
6037139802,"Census Tract 1398.02, Los Angeles County, California",1391,25,1285,84,106,80
6037141100,"Census Tract 1411, Los Angeles County, California",3028,115,943,161,2085,181
6037141200,"Census Tract 1412, Los Angeles County, California",3252,174,874,128,2378,182
6037141301,"Census Tract 1413.01, Los Angeles County, California",3129,135,890,155,2239,186
6037141302,"Census Tract 1413.02, Los Angeles County, California",2954,139,985,144,1969,179
6037141400,"Census Tract 1414, Los Angeles County, California",1917,36,1159,113,758,111
6037141500,"Census Tract 1415, Los Angeles County, California",1080,80,1006,92,74,73
6037141600,"Census Tract 1416, Los Angeles County, California",1615,70,1493,100,122,80
6037141700,"Census Tract 1417, Los Angeles County, California",1265,66,1243,68,22,26
6037143100,"Census Tract 1431, Los Angeles County, California",1852,160,912,168,940,179
6037143200,"Census Tract 1432, Los Angeles County, California",1871,160,375,108,1496,185
6037143300,"Census Tract 1433, Los Angeles County, California",2849,145,1218,153,1631,180
6037143400,"Census Tract 1434, Los Angeles County, California",2724,149,1233,157,1491,198
6037143500,"Census Tract 1435, Los Angeles County, California",2118,145,1121,120,997,149
6037143601,"Census Tract 1436.01, Los Angeles County, California",3111,215,577,154,2534,248
6037143602,"Census Tract 1436.02, Los Angeles County, California",1854,164,933,177,921,189
6037143700,"Census Tract 1437, Los Angeles County, California",2015,119,1636,156,379,137
6037143800,"Census Tract 1438, Los Angeles County, California",2355,154,1311,169,1044,176
6037143901,"Census Tract 1439.01, Los Angeles County, California",1637,77,1503,99,134,79
6037143902,"Census Tract 1439.02, Los Angeles County, California",1320,88,806,100,514,100
6037181000,"Census Tract 1810, Los Angeles County, California",2232,89,1766,127,466,153
6037181300,"Census Tract 1813, Los Angeles County, California",1338,70,986,104,352,80
6037181400,"Census Tract 1814, Los Angeles County, California",1503,81,567,100,936,124
6037181500,"Census Tract 1815, Los Angeles County, California",1310,73,938,119,372,119
6037181600,"Census Tract 1816, Los Angeles County, California",1531,80,509,106,1022,122
6037183101,"Census Tract 1831.01, Los Angeles County, California",1337,57,799,107,538,103
6037183102,"Census Tract 1831.02, Los Angeles County, California",2234,60,797,145,1437,139
6037183210,"Census Tract 1832.10, Los Angeles County, California",1937,65,961,116,976,115
6037183220,"Census Tract 1832.20, Los Angeles County, California",1070,75,418,72,652,88
6037183300,"Census Tract 1833, Los Angeles County, California",1389,63,808,126,581,122
6037183400,"Census Tract 1834, Los Angeles County, California",1204,76,634,125,570,129
6037183510,"Census Tract 1835.10, Los Angeles County, California",807,13,501,97,306,96
6037183520,"Census Tract 1835.20, Los Angeles County, California",1061,88,239,72,822,101
6037183610,"Census Tract 1836.10, Los Angeles County, California",970,56,197,78,773,99
6037183620,"Census Tract 1836.20, Los Angeles County, California",1015,60,359,104,656,116
6037183700,"Census Tract 1837, Los Angeles County, California",2201,142,807,167,1394,178
6037183810,"Census Tract 1838.10, Los Angeles County, California",1222,92,198,81,1024,109
6037183820,"Census Tract 1838.20, Los Angeles County, California",1012,93,249,91,763,121
6037185100,"Census Tract 1851, Los Angeles County, California",2116,173,1457,171,659,160
6037185201,"Census Tract 1852.01, Los Angeles County, California",1517,104,1030,125,487,124
6037185202,"Census Tract 1852.02, Los Angeles County, California",1418,61,581,117,837,134
6037185310,"Census Tract 1853.10, Los Angeles County, California",855,54,271,86,584,90
6037185320,"Census Tract 1853.20, Los Angeles County, California",900,51,381,91,519,101
6037186100,"Census Tract 1861, Los Angeles County, California",1676,116,954,145,722,142
6037186200,"Census Tract 1862, Los Angeles County, California",2846,146,1653,189,1193,210
6037186300,"Census Tract 1863, Los Angeles County, California",1972,97,1346,133,626,129
6037186401,"Census Tract 1864.01, Los Angeles County, California",1567,75,233,94,1334,108
6037186402,"Census Tract 1864.02, Los Angeles County, California",1472,64,557,112,915,125
6037187100,"Census Tract 1871, Los Angeles County, California",2265,140,1059,166,1206,168
6037187200,"Census Tract 1872, Los Angeles County, California",824,57,315,78,509,96
6037187300,"Census Tract 1873, Los Angeles County, California",1513,83,679,106,834,117
6037188100,"Census Tract 1881, Los Angeles County, California",1827,65,493,122,1334,129
6037188200,"Census Tract 1882, Los Angeles County, California",3036,197,1136,169,1900,216
6037188300,"Census Tract 1883, Los Angeles County, California",1383,77,802,102,581,103
6037189100,"Census Tract 1891, Los Angeles County, California",3238,182,778,184,2460,250
6037189200,"Census Tract 1892, Los Angeles County, California",3241,153,882,150,2359,201
6037189300,"Census Tract 1893, Los Angeles County, California",1266,90,1077,147,189,133
6037189400,"Census Tract 1894, Los Angeles County, California",1727,84,773,95,954,113
6037189500,"Census Tract 1895, Los Angeles County, California",2761,130,413,122,2348,162
6037189600,"Census Tract 1896, Los Angeles County, California",1896,156,660,121,1236,176
6037189701,"Census Tract 1897.01, Los Angeles County, California",2107,167,1131,132,976,169
6037189702,"Census Tract 1897.02, Los Angeles County, California",1133,96,522,85,611,99
6037189800,"Census Tract 1898, Los Angeles County, California",1356,91,488,92,868,129
6037189901,"Census Tract 1899.01, Los Angeles County, California",4212,165,580,159,3632,219
6037189902,"Census Tract 1899.02, Los Angeles County, California",2953,147,117,62,2836,143
6037190100,"Census Tract 1901, Los Angeles County, California",2901,192,182,79,2719,210
6037190200,"Census Tract 1902, Los Angeles County, California",3440,174,45,73,3395,180
6037190301,"Census Tract 1903.01, Los Angeles County, California",2364,180,60,41,2304,182
6037190400,"Census Tract 1904, Los Angeles County, California",3069,132,0,132,3069,132
6037190510,"Census Tract 1905.10, Los Angeles County, California",1518,117,0,132,1518,117
6037190520,"Census Tract 1905.20, Los Angeles County, California",1654,68,169,86,1485,106
6037190700,"Census Tract 1907, Los Angeles County, California",1604,97,90,51,1514,113
6037190800,"Census Tract 1908, Los Angeles County, California",2689,162,173,68,2516,181
6037190901,"Census Tract 1909.01, Los Angeles County, California",1508,92,89,61,1419,108
6037190902,"Census Tract 1909.02, Los Angeles County, California",1562,96,128,54,1434,104
6037191000,"Census Tract 1910, Los Angeles County, California",1263,111,18,32,1245,117
6037191110,"Census Tract 1911.10, Los Angeles County, California",1108,59,38,24,1070,64
6037191120,"Census Tract 1911.20, Los Angeles County, California",1557,99,130,66,1427,124
6037191201,"Census Tract 1912.01, Los Angeles County, California",1744,73,91,55,1653,86
6037191203,"Census Tract 1912.03, Los Angeles County, California",1238,70,145,76,1093,109
6037191204,"Census Tract 1912.04, Los Angeles County, California",869,41,265,122,604,118
6037191300,"Census Tract 1913, Los Angeles County, California",1857,99,175,75,1682,120
6037191410,"Census Tract 1914.10, Los Angeles County, California",1736,56,89,48,1647,76
6037191420,"Census Tract 1914.20, Los Angeles County, California",1198,61,59,43,1139,71
6037191500,"Census Tract 1915, Los Angeles County, California",1677,102,271,84,1406,115
6037191610,"Census Tract 1916.10, Los Angeles County, California",1401,81,219,71,1182,114
6037191620,"Census Tract 1916.20, Los Angeles County, California",836,62,71,48,765,72
6037191710,"Census Tract 1917.10, Los Angeles County, California",1304,81,128,57,1176,100
6037191720,"Census Tract 1917.20, Los Angeles County, California",1350,88,29,26,1321,93
6037191810,"Census Tract 1918.10, Los Angeles County, California",1313,83,64,54,1249,90
6037191820,"Census Tract 1918.20, Los Angeles County, California",1177,96,16,18,1161,97
6037191900,"Census Tract 1919, Los Angeles County, California",3411,108,791,162,2620,184
6037192000,"Census Tract 1920, Los Angeles County, California",2594,123,859,152,1735,173
6037192300,"Census Tract 1923, Los Angeles County, California",1527,101,594,135,933,175
6037192410,"Census Tract 1924.10, Los Angeles County, California",1706,83,506,94,1200,111
6037192420,"Census Tract 1924.20, Los Angeles County, California",1503,60,238,78,1265,92
6037192510,"Census Tract 1925.10, Los Angeles County, California",1191,41,173,72,1018,82
6037192520,"Census Tract 1925.20, Los Angeles County, California",1561,93,97,58,1464,113
6037192610,"Census Tract 1926.10, Los Angeles County, California",1361,96,206,80,1155,100
6037192620,"Census Tract 1926.20, Los Angeles County, California",1343,55,69,67,1274,78
6037192700,"Census Tract 1927, Los Angeles County, California",1071,76,161,91,910,123
6037194100,"Census Tract 1941, Los Angeles County, California",3358,159,1787,164,1571,188
6037194200,"Census Tract 1942, Los Angeles County, California",2814,163,1547,158,1267,175
6037194300,"Census Tract 1943, Los Angeles County, California",1018,85,825,97,193,88
6037194400,"Census Tract 1944, Los Angeles County, California",3366,180,541,152,2825,219
6037194500,"Census Tract 1945, Los Angeles County, California",937,76,487,86,450,86
6037195100,"Census Tract 1951, Los Angeles County, California",2069,128,1376,167,693,184
6037195200,"Census Tract 1952, Los Angeles County, California",3204,96,1188,176,2016,185
6037195300,"Census Tract 1953, Los Angeles County, California",1590,66,340,82,1250,98
6037195400,"Census Tract 1954, Los Angeles County, California",2389,85,943,151,1446,160
6037195500,"Census Tract 1955, Los Angeles County, California",2309,104,1149,173,1160,178
6037195600,"Census Tract 1956, Los Angeles County, California",1149,85,371,94,778,110
6037195710,"Census Tract 1957.10, Los Angeles County, California",1365,58,182,63,1183,81
6037195720,"Census Tract 1957.20, Los Angeles County, California",986,82,138,63,848,96
6037195801,"Census Tract 1958.01, Los Angeles County, California",2302,117,646,162,1656,198
6037195802,"Census Tract 1958.02, Los Angeles County, California",923,45,62,52,861,74
6037195900,"Census Tract 1959, Los Angeles County, California",3059,144,279,139,2780,196
6037197110,"Census Tract 1971.10, Los Angeles County, California",187,65,140,58,47,37
6037197200,"Census Tract 1972, Los Angeles County, California",1596,84,731,143,865,141
6037197300,"Census Tract 1973, Los Angeles County, California",1676,104,463,120,1213,136
6037197410,"Census Tract 1974.10, Los Angeles County, California",1202,98,566,114,636,142
6037197420,"Census Tract 1974.20, Los Angeles County, California",1237,87,399,96,838,111
6037197500,"Census Tract 1975, Los Angeles County, California",1418,130,329,108,1089,140
6037197600,"Census Tract 1976, Los Angeles County, California",777,102,204,69,573,98
6037197700,"Census Tract 1977, Los Angeles County, California",1773,82,257,91,1516,115
6037199000,"Census Tract 1990, Los Angeles County, California",1256,90,340,83,916,103
6037199110,"Census Tract 1991.10, Los Angeles County, California",763,67,276,65,487,77
6037199120,"Census Tract 1991.20, Los Angeles County, California",1008,50,100,51,908,72
6037199201,"Census Tract 1992.01, Los Angeles County, California",1143,98,143,71,1000,129
6037199202,"Census Tract 1992.02, Los Angeles County, California",829,67,263,72,566,86
6037199300,"Census Tract 1993, Los Angeles County, California",1169,100,791,102,378,113
6037199400,"Census Tract 1994, Los Angeles County, California",1403,41,494,111,909,111
6037199700,"Census Tract 1997, Los Angeles County, California",957,46,322,89,635,93
6037199800,"Census Tract 1998, Los Angeles County, California",1499,95,437,95,1062,128
6037199900,"Census Tract 1999, Los Angeles County, California",805,52,98,48,707,69
6037201110,"Census Tract 2011.10, Los Angeles County, California",454,50,267,60,187,64
6037201120,"Census Tract 2011.20, Los Angeles County, California",1380,90,594,89,786,112
6037201200,"Census Tract 2012, Los Angeles County, California",697,77,189,78,508,101
6037201301,"Census Tract 2013.01, Los Angeles County, California",965,69,391,106,574,113
6037201302,"Census Tract 2013.02, Los Angeles County, California",1969,78,1489,132,480,118
6037201401,"Census Tract 2014.01, Los Angeles County, California",1417,51,703,102,714,106
6037201402,"Census Tract 2014.02, Los Angeles County, California",1412,64,922,129,490,131
6037201501,"Census Tract 2015.01, Los Angeles County, California",1559,78,609,112,950,113
6037201503,"Census Tract 2015.03, Los Angeles County, California",888,70,283,73,605,99
6037201504,"Census Tract 2015.04, Los Angeles County, California",660,21,400,79,260,80
6037201600,"Census Tract 2016, Los Angeles County, California",1479,63,790,141,689,134
6037201700,"Census Tract 2017, Los Angeles County, California",1350,80,671,95,679,118
6037203100,"Census Tract 2031, Los Angeles County, California",1131,74,122,66,1009,98
6037203200,"Census Tract 2032, Los Angeles County, California",1249,62,363,78,886,98
6037203300,"Census Tract 2033, Los Angeles County, California",119,57,30,28,89,58
6037203500,"Census Tract 2035, Los Angeles County, California",1125,75,196,70,929,94
6037203600,"Census Tract 2036, Los Angeles County, California",1538,92,310,99,1228,123
6037203710,"Census Tract 2037.10, Los Angeles County, California",879,38,252,98,627,103
6037203720,"Census Tract 2037.20, Los Angeles County, California",1082,72,165,73,917,101
6037203800,"Census Tract 2038, Los Angeles County, California",1210,70,595,103,615,124
6037203900,"Census Tract 2039, Los Angeles County, California",696,70,261,79,435,79
6037204110,"Census Tract 2041.10, Los Angeles County, California",763,92,236,75,527,91
6037204120,"Census Tract 2041.20, Los Angeles County, California",690,60,251,84,439,96
6037204200,"Census Tract 2042, Los Angeles County, California",972,62,205,100,767,106
6037204300,"Census Tract 2043, Los Angeles County, California",1316,64,406,102,910,113
6037204410,"Census Tract 2044.10, Los Angeles County, California",581,55,64,40,517,61
6037204420,"Census Tract 2044.20, Los Angeles County, California",931,98,123,48,808,106
6037204600,"Census Tract 2046, Los Angeles County, California",1004,86,331,96,673,112
6037204700,"Census Tract 2047, Los Angeles County, California",1168,69,371,86,797,112
6037204810,"Census Tract 2048.10, Los Angeles County, California",1045,73,296,77,749,99
6037204820,"Census Tract 2048.20, Los Angeles County, California",386,118,124,73,262,85
6037204910,"Census Tract 2049.10, Los Angeles County, California",771,41,240,73,531,74
6037204920,"Census Tract 2049.20, Los Angeles County, California",638,44,352,57,286,61
6037205110,"Census Tract 2051.10, Los Angeles County, California",920,32,0,132,920,32
6037205120,"Census Tract 2051.20, Los Angeles County, California",908,75,116,52,792,88
6037206010,"Census Tract 2060.10, Los Angeles County, California",825,66,34,35,791,72
6037206020,"Census Tract 2060.20, Los Angeles County, California",86,61,0,132,86,61
6037206030,"Census Tract 2060.30, Los Angeles County, California",509,72,63,60,446,81
6037206040,"Census Tract 2060.40, Los Angeles County, California",1040,123,263,79,777,127
6037206050,"Census Tract 2060.50, Los Angeles County, California",1238,76,168,61,1070,80
6037206200,"Census Tract 2062, Los Angeles County, California",1276,103,163,83,1113,136
6037206300,"Census Tract 2063, Los Angeles County, California",1652,126,40,36,1612,122
6037207100,"Census Tract 2071, Los Angeles County, California",2429,132,93,63,2336,136
6037207300,"Census Tract 2073, Los Angeles County, California",3394,239,237,93,3157,254
6037207400,"Census Tract 2074, Los Angeles County, California",0,132,0,132,0,132
6037207500,"Census Tract 2075, Los Angeles County, California",2846,168,285,85,2561,169
6037207710,"Census Tract 2077.10, Los Angeles County, California",1040,89,43,32,997,87
6037207900,"Census Tract 2079, Los Angeles County, California",1341,116,182,72,1159,128
6037208000,"Census Tract 2080, Los Angeles County, California",1377,66,113,64,1264,94
6037208300,"Census Tract 2083, Los Angeles County, California",2354,112,151,86,2203,130
6037208400,"Census Tract 2084, Los Angeles County, California",1800,131,95,55,1705,136
6037208500,"Census Tract 2085, Los Angeles County, California",2103,90,65,51,2038,108
6037208610,"Census Tract 2086.10, Los Angeles County, California",1486,61,237,86,1249,111
6037208620,"Census Tract 2086.20, Los Angeles County, California",1574,100,155,58,1419,102
6037208710,"Census Tract 2087.10, Los Angeles County, California",1923,81,220,96,1703,110
6037208720,"Census Tract 2087.20, Los Angeles County, California",1465,82,21,24,1444,81
6037208800,"Census Tract 2088, Los Angeles County, California",2326,146,5,12,2321,148
6037208902,"Census Tract 2089.02, Los Angeles County, California",560,70,0,132,560,70
6037208903,"Census Tract 2089.03, Los Angeles County, California",1137,87,0,132,1137,87
6037208904,"Census Tract 2089.04, Los Angeles County, California",1292,63,0,132,1292,63
6037209101,"Census Tract 2091.01, Los Angeles County, California",1909,96,0,132,1909,96
6037209102,"Census Tract 2091.02, Los Angeles County, California",1730,87,42,39,1688,87
6037209200,"Census Tract 2092, Los Angeles County, California",812,85,15,20,797,82
6037209300,"Census Tract 2093, Los Angeles County, California",1736,94,46,36,1690,101
6037209401,"Census Tract 2094.01, Los Angeles County, California",1201,157,0,132,1201,157
6037209402,"Census Tract 2094.02, Los Angeles County, California",997,109,13,18,984,106
6037209403,"Census Tract 2094.03, Los Angeles County, California",1211,71,0,132,1211,71
6037209510,"Census Tract 2095.10, Los Angeles County, California",902,87,0,132,902,87
6037209520,"Census Tract 2095.20, Los Angeles County, California",874,83,69,51,805,100
6037209810,"Census Tract 2098.10, Los Angeles County, California",647,82,38,22,609,81
6037209820,"Census Tract 2098.20, Los Angeles County, California",814,89,106,61,708,104
6037210010,"Census Tract 2100.10, Los Angeles County, California",1155,63,111,55,1044,79
6037211000,"Census Tract 2110, Los Angeles County, California",1628,65,1331,113,297,103
6037211110,"Census Tract 2111.10, Los Angeles County, California",2019,148,70,55,1949,155
6037211120,"Census Tract 2111.20, Los Angeles County, California",1919,132,14,24,1905,133
6037211200,"Census Tract 2112, Los Angeles County, California",1911,126,190,75,1721,136
6037211310,"Census Tract 2113.10, Los Angeles County, California",1332,53,49,39,1283,64
6037211320,"Census Tract 2113.20, Los Angeles County, California",1337,46,86,79,1251,93
6037211410,"Census Tract 2114.10, Los Angeles County, California",1232,33,72,43,1160,53
6037211420,"Census Tract 2114.20, Los Angeles County, California",1254,78,216,51,1038,90
6037211500,"Census Tract 2115, Los Angeles County, California",1712,79,666,99,1046,115
6037211701,"Census Tract 2117.01, Los Angeles County, California",1337,76,350,82,987,102
6037211702,"Census Tract 2117.02, Los Angeles County, California",3537,122,221,111,3316,152
6037211801,"Census Tract 2118.01, Los Angeles County, California",3015,92,263,93,2752,134
6037211802,"Census Tract 2118.02, Los Angeles County, California",2107,93,101,58,2006,112
6037211910,"Census Tract 2119.10, Los Angeles County, California",1725,77,53,37,1672,79
6037211920,"Census Tract 2119.20, Los Angeles County, California",2384,123,11,17,2373,123
6037212100,"Census Tract 2121, Los Angeles County, California",2403,138,114,80,2289,150
6037212202,"Census Tract 2122.02, Los Angeles County, California",1197,86,56,74,1141,116
6037212203,"Census Tract 2122.03, Los Angeles County, California",1083,59,0,132,1083,59
6037212204,"Census Tract 2122.04, Los Angeles County, California",1227,95,0,132,1227,95
6037212303,"Census Tract 2123.03, Los Angeles County, California",1242,63,0,132,1242,63
6037212304,"Census Tract 2123.04, Los Angeles County, California",781,84,0,132,781,84
6037212305,"Census Tract 2123.05, Los Angeles County, California",977,68,6,13,971,68
6037212306,"Census Tract 2123.06, Los Angeles County, California",1178,50,0,132,1178,50
6037212410,"Census Tract 2124.10, Los Angeles County, California",1696,53,77,38,1619,68
6037212420,"Census Tract 2124.20, Los Angeles County, California",1108,95,43,49,1065,84
6037212500,"Census Tract 2125, Los Angeles County, California",2021,115,92,63,1929,127
6037212610,"Census Tract 2126.10, Los Angeles County, California",1574,87,175,80,1399,121
6037212620,"Census Tract 2126.20, Los Angeles County, California",1770,79,145,58,1625,94
6037212700,"Census Tract 2127, Los Angeles County, California",2205,116,1152,170,1053,199
6037212800,"Census Tract 2128, Los Angeles County, California",1284,108,449,108,835,133
6037212900,"Census Tract 2129, Los Angeles County, California",1485,78,106,47,1379,91
6037213100,"Census Tract 2131, Los Angeles County, California",845,62,270,75,575,105
6037213201,"Census Tract 2132.01, Los Angeles County, California",1273,85,91,61,1182,100
6037213202,"Census Tract 2132.02, Los Angeles County, California",1196,83,155,65,1041,101
6037213310,"Census Tract 2133.10, Los Angeles County, California",977,98,153,72,824,105
6037213320,"Census Tract 2133.20, Los Angeles County, California",993,73,92,47,901,80
6037213401,"Census Tract 2134.01, Los Angeles County, California",1685,54,41,38,1644,66
6037213402,"Census Tract 2134.02, Los Angeles County, California",1551,88,110,60,1441,110
6037214000,"Census Tract 2140, Los Angeles County, California",1345,72,698,95,647,107
6037214100,"Census Tract 2141, Los Angeles County, California",1686,80,629,90,1057,97
6037214400,"Census Tract 2144, Los Angeles County, California",1685,100,21,23,1664,100
6037214500,"Census Tract 2145, Los Angeles County, California",5225,243,32,22,5193,247
6037214600,"Census Tract 2146, Los Angeles County, California",1298,91,279,78,1019,111
6037214700,"Census Tract 2147, Los Angeles County, California",1285,76,459,96,826,125
6037214800,"Census Tract 2148, Los Angeles County, California",1330,119,343,96,987,131
6037214900,"Census Tract 2149, Los Angeles County, California",3533,177,753,155,2780,215
6037215100,"Census Tract 2151, Los Angeles County, California",3591,234,15,25,3576,238
6037216100,"Census Tract 2161, Los Angeles County, California",1078,69,407,90,671,106
6037216200,"Census Tract 2162, Los Angeles County, California",2091,150,494,132,1597,145
6037216300,"Census Tract 2163, Los Angeles County, California",2362,108,864,152,1498,199
6037216400,"Census Tract 2164, Los Angeles County, California",3258,131,440,140,2818,195
6037216700,"Census Tract 2167, Los Angeles County, California",1533,103,537,101,996,147
6037216800,"Census Tract 2168, Los Angeles County, California",1569,58,586,112,983,132
6037216900,"Census Tract 2169, Los Angeles County, California",2475,141,832,182,1643,217
6037217000,"Census Tract 2170, Los Angeles County, California",2968,138,823,177,2145,215
6037217100,"Census Tract 2171, Los Angeles County, California",2345,226,558,142,1787,257
6037217200,"Census Tract 2172, Los Angeles County, California",1568,90,537,103,1031,141
6037218110,"Census Tract 2181.10, Los Angeles County, California",1212,66,293,65,919,94
6037218120,"Census Tract 2181.20, Los Angeles County, California",1337,75,281,90,1056,90
6037218210,"Census Tract 2182.10, Los Angeles County, California",1224,62,193,77,1031,105
6037218220,"Census Tract 2182.20, Los Angeles County, California",1486,77,524,112,962,121
6037218300,"Census Tract 2183, Los Angeles County, California",1979,112,493,105,1486,124
6037218400,"Census Tract 2184, Los Angeles County, California",1886,80,775,134,1111,154
6037218500,"Census Tract 2185, Los Angeles County, California",1074,98,372,106,702,141
6037218600,"Census Tract 2186, Los Angeles County, California",1335,127,568,92,767,139
6037218700,"Census Tract 2187, Los Angeles County, California",1516,66,479,105,1037,115
6037218800,"Census Tract 2188, Los Angeles County, California",931,61,251,82,680,102
6037218900,"Census Tract 2189, Los Angeles County, California",1946,166,401,147,1545,193
6037219010,"Census Tract 2190.10, Los Angeles County, California",796,55,343,80,453,86
6037219020,"Census Tract 2190.20, Los Angeles County, California",1229,105,580,138,649,129
6037219300,"Census Tract 2193, Los Angeles County, California",1375,110,359,102,1016,143
6037219500,"Census Tract 2195, Los Angeles County, California",774,19,506,98,268,103
6037219700,"Census Tract 2197, Los Angeles County, California",914,71,487,88,427,105
6037219800,"Census Tract 2198, Los Angeles County, California",1458,86,386,115,1072,127
6037219900,"Census Tract 2199, Los Angeles County, California",1638,93,640,124,998,137
6037220000,"Census Tract 2200, Los Angeles County, California",1994,113,692,128,1302,154
6037220100,"Census Tract 2201, Los Angeles County, California",1074,26,530,93,544,91
6037221110,"Census Tract 2211.10, Los Angeles County, California",1092,87,96,59,996,101
6037221120,"Census Tract 2211.20, Los Angeles County, California",849,50,162,69,687,83
6037221210,"Census Tract 2212.10, Los Angeles County, California",858,62,294,81,564,104
6037221220,"Census Tract 2212.20, Los Angeles County, California",941,115,143,78,798,130
6037221301,"Census Tract 2213.01, Los Angeles County, California",1841,58,163,71,1678,87
6037221302,"Census Tract 2213.02, Los Angeles County, California",1373,60,200,79,1173,92
6037221400,"Census Tract 2214, Los Angeles County, California",1736,58,312,98,1424,118
6037221500,"Census Tract 2215, Los Angeles County, California",1751,84,311,79,1440,117
6037221600,"Census Tract 2216, Los Angeles County, California",1332,79,251,80,1081,113
6037221710,"Census Tract 2217.10, Los Angeles County, California",1388,70,234,108,1154,126
6037221810,"Census Tract 2218.10, Los Angeles County, California",885,61,144,58,741,76
6037221820,"Census Tract 2218.20, Los Angeles County, California",939,77,39,14,900,78
6037221900,"Census Tract 2219, Los Angeles County, California",975,105,42,34,933,112
6037222000,"Census Tract 2220, Los Angeles County, California",2228,124,1031,161,1197,172
6037222100,"Census Tract 2221, Los Angeles County, California",1072,82,303,97,769,100
6037222200,"Census Tract 2222, Los Angeles County, California",1065,88,290,72,775,112
6037222500,"Census Tract 2225, Los Angeles County, California",1327,68,392,75,935,98
6037222600,"Census Tract 2226, Los Angeles County, California",1537,102,339,138,1198,122
6037222700,"Census Tract 2227, Los Angeles County, California",26,21,0,132,26,21
6037224010,"Census Tract 2240.10, Los Angeles County, California",1029,67,0,132,1029,67
6037224020,"Census Tract 2240.20, Los Angeles County, California",559,101,60,37,499,109
6037224200,"Census Tract 2242, Los Angeles County, California",912,50,110,51,802,72
6037224310,"Census Tract 2243.10, Los Angeles County, California",617,50,28,30,589,58
6037224320,"Census Tract 2243.20, Los Angeles County, California",1048,73,68,36,980,83
6037224410,"Census Tract 2244.10, Los Angeles County, California",934,90,83,41,851,91
6037224420,"Census Tract 2244.20, Los Angeles County, California",654,101,57,41,597,104
6037224600,"Census Tract 2246, Los Angeles County, California",874,81,89,44,785,91
6037224700,"Census Tract 2247, Los Angeles County, California",542,90,0,132,542,90
6037226000,"Census Tract 2260, Los Angeles County, California",1302,131,232,99,1070,147
6037226410,"Census Tract 2264.10, Los Angeles County, California",864,50,100,44,764,62
6037226420,"Census Tract 2264.20, Los Angeles County, California",1079,87,265,85,814,112
6037226700,"Census Tract 2267, Los Angeles County, California",1361,64,409,101,952,114
6037227010,"Census Tract 2270.10, Los Angeles County, California",916,63,308,91,608,101
6037227020,"Census Tract 2270.20, Los Angeles County, California",656,96,135,76,521,124
6037228100,"Census Tract 2281, Los Angeles County, California",1137,60,339,99,798,115
6037228210,"Census Tract 2282.10, Los Angeles County, California",803,65,220,79,583,89
6037228220,"Census Tract 2282.20, Los Angeles County, California",865,83,256,91,609,118
6037228310,"Census Tract 2283.10, Los Angeles County, California",986,60,279,90,707,90
6037228320,"Census Tract 2283.20, Los Angeles County, California",799,48,247,75,552,79
6037228410,"Census Tract 2284.10, Los Angeles County, California",1037,87,369,103,668,133
6037228420,"Census Tract 2284.20, Los Angeles County, California",736,55,159,84,577,101
6037228500,"Census Tract 2285, Los Angeles County, California",989,79,449,78,540,97
6037228600,"Census Tract 2286, Los Angeles County, California",1082,87,312,83,770,116
6037228710,"Census Tract 2287.10, Los Angeles County, California",973,82,212,75,761,109
6037228720,"Census Tract 2287.20, Los Angeles County, California",1009,61,312,91,697,105
6037228800,"Census Tract 2288, Los Angeles County, California",1171,70,484,83,687,96
6037228900,"Census Tract 2289, Los Angeles County, California",783,46,131,44,652,66
6037229100,"Census Tract 2291, Los Angeles County, California",920,64,509,109,411,114
6037229200,"Census Tract 2292, Los Angeles County, California",1137,86,263,81,874,102
6037229300,"Census Tract 2293, Los Angeles County, California",1246,71,264,83,982,100
6037229410,"Census Tract 2294.10, Los Angeles County, California",883,49,247,72,636,89
6037229420,"Census Tract 2294.20, Los Angeles County, California",912,86,338,93,574,109
6037231100,"Census Tract 2311, Los Angeles County, California",460,89,15,25,445,84
6037231210,"Census Tract 2312.10, Los Angeles County, California",1072,61,123,69,949,81
6037231220,"Census Tract 2312.20, Los Angeles County, California",1097,68,164,69,933,97
6037231300,"Census Tract 2313, Los Angeles County, California",1240,107,462,104,778,134
6037231400,"Census Tract 2314, Los Angeles County, California",1280,87,619,118,661,119
6037231500,"Census Tract 2315, Los Angeles County, California",1433,78,916,131,517,122
6037231600,"Census Tract 2316, Los Angeles County, California",1922,93,633,113,1289,117
6037231710,"Census Tract 2317.10, Los Angeles County, California",1234,69,58,36,1176,74
6037231720,"Census Tract 2317.20, Los Angeles County, California",1255,62,349,112,906,121
6037231800,"Census Tract 2318, Los Angeles County, California",1545,81,261,98,1284,128
6037231900,"Census Tract 2319, Los Angeles County, California",1532,86,347,112,1185,134
6037232110,"Census Tract 2321.10, Los Angeles County, California",850,89,270,90,580,114
6037232120,"Census Tract 2321.20, Los Angeles County, California",977,68,206,72,771,102
6037232200,"Census Tract 2322, Los Angeles County, California",857,81,342,94,515,124
6037232300,"Census Tract 2323, Los Angeles County, California",1028,89,651,128,377,133
6037232400,"Census Tract 2324, Los Angeles County, California",1866,149,727,132,1139,184
6037232500,"Census Tract 2325, Los Angeles County, California",1360,109,575,107,785,131
6037232600,"Census Tract 2326, Los Angeles County, California",1706,92,749,117,957,134
6037232700,"Census Tract 2327, Los Angeles County, California",1357,57,419,93,938,103
6037232800,"Census Tract 2328, Los Angeles County, California",1170,73,343,80,827,109
6037234000,"Census Tract 2340, Los Angeles County, California",1973,102,1203,114,770,135
6037234200,"Census Tract 2342, Los Angeles County, California",1154,25,709,109,445,108
6037234300,"Census Tract 2343, Los Angeles County, California",2373,131,482,140,1891,184
6037234500,"Census Tract 2345, Los Angeles County, California",1853,134,676,137,1177,160
6037234600,"Census Tract 2346, Los Angeles County, California",1657,102,1056,145,601,138
6037234700,"Census Tract 2347, Los Angeles County, California",1429,60,541,100,888,105
6037234800,"Census Tract 2348, Los Angeles County, California",1084,60,777,96,307,96
6037234900,"Census Tract 2349, Los Angeles County, California",2468,180,257,123,2211,196
6037235100,"Census Tract 2351, Los Angeles County, California",1744,90,1309,125,435,116
6037235201,"Census Tract 2352.01, Los Angeles County, California",939,68,598,105,341,116
6037235202,"Census Tract 2352.02, Los Angeles County, California",1725,152,490,112,1235,174
6037236000,"Census Tract 2360, Los Angeles County, California",2007,123,1614,149,393,131
6037236100,"Census Tract 2361, Los Angeles County, California",2593,150,330,84,2263,154
6037236201,"Census Tract 2362.01, Los Angeles County, California",2846,115,58,53,2788,124
6037236202,"Census Tract 2362.02, Los Angeles County, California",2439,123,16,25,2423,128
6037236400,"Census Tract 2364, Los Angeles County, California",2169,60,931,157,1238,165
6037237100,"Census Tract 2371, Los Angeles County, California",1818,107,646,188,1172,172
6037237200,"Census Tract 2372, Los Angeles County, California",1890,104,781,137,1109,164
6037237300,"Census Tract 2373, Los Angeles County, California",1918,96,1041,141,877,152
6037237400,"Census Tract 2374, Los Angeles County, California",2266,121,1273,210,993,249
6037237500,"Census Tract 2375, Los Angeles County, California",1038,97,278,85,760,119
6037237600,"Census Tract 2376, Los Angeles County, California",1764,57,542,137,1222,139
6037237710,"Census Tract 2377.10, Los Angeles County, California",1191,74,261,83,930,109
6037237720,"Census Tract 2377.20, Los Angeles County, California",1039,51,102,64,937,86
6037237800,"Census Tract 2378, Los Angeles County, California",1395,85,1017,120,378,123
6037237900,"Census Tract 2379, Los Angeles County, California",1335,61,933,130,402,128
6037238000,"Census Tract 2380, Los Angeles County, California",2133,98,1542,174,591,161
6037238100,"Census Tract 2381, Los Angeles County, California",1690,85,807,105,883,100
6037238200,"Census Tract 2382, Los Angeles County, California",2115,146,732,169,1383,187
6037238310,"Census Tract 2383.10, Los Angeles County, California",1588,69,142,64,1446,85
6037238320,"Census Tract 2383.20, Los Angeles County, California",1168,103,148,72,1020,121
6037238400,"Census Tract 2384, Los Angeles County, California",1725,90,1062,163,663,169
6037239200,"Census Tract 2392, Los Angeles County, California",1828,67,567,112,1261,132
6037239310,"Census Tract 2393.10, Los Angeles County, California",597,63,308,76,289,84
6037239320,"Census Tract 2393.20, Los Angeles County, California",788,48,258,75,530,83
6037239330,"Census Tract 2393.30, Los Angeles County, California",684,43,313,69,371,72
6037239500,"Census Tract 2395, Los Angeles County, California",1635,104,731,120,904,160
6037239600,"Census Tract 2396, Los Angeles County, California",1377,95,408,104,969,131
6037239700,"Census Tract 2397, Los Angeles County, California",1726,66,636,112,1090,114
6037239800,"Census Tract 2398, Los Angeles County, California",2023,133,768,188,1255,234
6037240010,"Census Tract 2400.10, Los Angeles County, California",894,88,295,92,599,117
6037240020,"Census Tract 2400.20, Los Angeles County, California",1189,86,545,101,644,111
6037240200,"Census Tract 2402, Los Angeles County, California",1631,80,552,116,1079,126
6037240300,"Census Tract 2403, Los Angeles County, California",1724,106,459,119,1265,137
6037240400,"Census Tract 2404, Los Angeles County, California",1744,75,574,125,1170,134
6037240500,"Census Tract 2405, Los Angeles County, California",1840,82,515,106,1325,125
6037240600,"Census Tract 2406, Los Angeles County, California",1216,91,399,106,817,126
6037240700,"Census Tract 2407, Los Angeles County, California",1573,71,820,137,753,137
6037240800,"Census Tract 2408, Los Angeles County, California",1060,72,406,111,654,121
6037240900,"Census Tract 2409, Los Angeles County, California",1271,88,601,111,670,137
6037241000,"Census Tract 2410, Los Angeles County, California",1791,84,869,149,922,154
6037241110,"Census Tract 2411.10, Los Angeles County, California",827,45,249,60,578,76
6037241120,"Census Tract 2411.20, Los Angeles County, California",1591,94,462,116,1129,130
6037241200,"Census Tract 2412, Los Angeles County, California",1447,100,868,128,579,127
6037241300,"Census Tract 2413, Los Angeles County, California",887,64,374,73,513,91
6037241400,"Census Tract 2414, Los Angeles County, California",1221,70,506,99,715,111
6037242000,"Census Tract 2420, Los Angeles County, California",894,81,334,92,560,102
6037242100,"Census Tract 2421, Los Angeles County, California",735,34,0,132,735,34
6037242200,"Census Tract 2422, Los Angeles County, California",1572,61,598,118,974,120
6037242300,"Census Tract 2423, Los Angeles County, California",1043,91,307,92,736,126
6037242600,"Census Tract 2426, Los Angeles County, California",1143,97,28,22,1115,96
6037242700,"Census Tract 2427, Los Angeles County, California",1165,71,541,104,624,122
6037243000,"Census Tract 2430, Los Angeles County, California",1248,86,573,129,675,143
6037243100,"Census Tract 2431, Los Angeles County, California",1272,76,337,87,935,108
6037261101,"Census Tract 2611.01, Los Angeles County, California",1658,118,1553,119,105,67
6037261102,"Census Tract 2611.02, Los Angeles County, California",1666,110,1575,116,91,53
6037261200,"Census Tract 2612, Los Angeles County, California",1777,85,1511,128,266,115
6037262100,"Census Tract 2621, Los Angeles County, California",1313,96,1217,98,96,47
6037262200,"Census Tract 2622, Los Angeles County, California",1746,90,1573,104,173,63
6037262301,"Census Tract 2623.01, Los Angeles County, California",914,49,857,64,57,56
6037262302,"Census Tract 2623.02, Los Angeles County, California",1313,17,1024,75,289,74
6037262303,"Census Tract 2623.03, Los Angeles County, California",1120,73,1034,78,86,62
6037262400,"Census Tract 2624, Los Angeles County, California",1265,41,1141,85,124,81
6037262500,"Census Tract 2625, Los Angeles County, California",1386,82,1182,96,204,72
6037262601,"Census Tract 2626.01, Los Angeles County, California",1285,61,1202,69,83,44
6037262602,"Census Tract 2626.02, Los Angeles County, California",2614,150,2296,146,318,120
6037262701,"Census Tract 2627.01, Los Angeles County, California",1531,94,1046,104,485,117
6037262702,"Census Tract 2627.02, Los Angeles County, California",1299,87,1008,96,291,97
6037262800,"Census Tract 2628, Los Angeles County, California",1515,85,1257,107,258,95
6037264000,"Census Tract 2640, Los Angeles County, California",1244,80,1029,118,215,111
6037264101,"Census Tract 2641.01, Los Angeles County, California",3142,178,835,183,2307,215
6037264301,"Census Tract 2643.01, Los Angeles County, California",2795,217,498,161,2297,248
6037264302,"Census Tract 2643.02, Los Angeles County, California",2877,125,1235,200,1642,201
6037265100,"Census Tract 2651, Los Angeles County, California",1193,109,937,112,256,128
6037265200,"Census Tract 2652, Los Angeles County, California",2182,176,1322,180,860,183
6037265301,"Census Tract 2653.01, Los Angeles County, California",417,59,119,51,298,71
6037265303,"Census Tract 2653.03, Los Angeles County, California",1371,86,71,39,1300,99
6037265304,"Census Tract 2653.04, Los Angeles County, California",929,87,5,10,924,88
6037265305,"Census Tract 2653.05, Los Angeles County, California",1418,90,80,51,1338,95
6037265410,"Census Tract 2654.10, Los Angeles County, California",623,56,395,76,228,85
6037265420,"Census Tract 2654.20, Los Angeles County, California",702,71,599,86,103,52
6037265510,"Census Tract 2655.10, Los Angeles County, California",2016,211,356,115,1660,217
6037265520,"Census Tract 2655.20, Los Angeles County, California",2182,145,551,168,1631,175
6037265600,"Census Tract 2656, Los Angeles County, California",3200,117,1721,213,1479,211
6037265700,"Census Tract 2657, Los Angeles County, California",2451,163,1333,178,1118,224
6037267100,"Census Tract 2671, Los Angeles County, California",2825,146,1525,187,1300,233
6037267200,"Census Tract 2672, Los Angeles County, California",2750,140,1109,163,1641,207
6037267300,"Census Tract 2673, Los Angeles County, California",2647,171,247,80,2400,189
6037267401,"Census Tract 2674.01, Los Angeles County, California",3469,250,254,124,3215,280
6037267402,"Census Tract 2674.02, Los Angeles County, California",2305,194,387,91,1918,202
6037267501,"Census Tract 2675.01, Los Angeles County, California",2478,177,396,120,2082,188
6037267502,"Census Tract 2675.02, Los Angeles County, California",1537,103,299,96,1238,132
6037267600,"Census Tract 2676, Los Angeles County, California",1243,47,465,105,778,108
6037267700,"Census Tract 2677, Los Angeles County, California",717,64,243,62,474,86
6037267800,"Census Tract 2678, Los Angeles County, California",1173,55,760,120,413,125
6037267900,"Census Tract 2679, Los Angeles County, California",3153,222,2115,228,1038,228
6037269000,"Census Tract 2690, Los Angeles County, California",2076,122,1247,123,829,177
6037269100,"Census Tract 2691, Los Angeles County, California",2193,115,867,157,1326,180
6037269300,"Census Tract 2693, Los Angeles County, California",1728,87,1229,122,499,119
6037269500,"Census Tract 2695, Los Angeles County, California",1414,67,1361,73,53,33
6037269600,"Census Tract 2696, Los Angeles County, California",2147,125,296,98,1851,148
6037269700,"Census Tract 2697, Los Angeles County, California",1693,75,783,99,910,124
6037269800,"Census Tract 2698, Los Angeles County, California",1501,94,299,79,1202,107
6037269901,"Census Tract 2699.01, Los Angeles County, California",4195,164,194,82,4001,171
6037269902,"Census Tract 2699.02, Los Angeles County, California",3780,168,100,69,3680,184
6037270100,"Census Tract 2701, Los Angeles County, California",2512,113,251,108,2261,167
6037270200,"Census Tract 2702, Los Angeles County, California",803,69,311,85,492,99
6037270300,"Census Tract 2703, Los Angeles County, California",1261,80,621,119,640,123
6037271100,"Census Tract 2711, Los Angeles County, California",1581,87,809,109,772,116
6037271200,"Census Tract 2712, Los Angeles County, California",1714,94,625,103,1089,122
6037271300,"Census Tract 2713, Los Angeles County, California",1360,78,623,85,737,90
6037271400,"Census Tract 2714, Los Angeles County, California",1292,69,1240,74,52,44
6037271500,"Census Tract 2715, Los Angeles County, California",1380,53,797,89,583,104
6037271600,"Census Tract 2716, Los Angeles County, California",1224,85,657,83,567,95
6037271701,"Census Tract 2717.01, Los Angeles County, California",2610,134,562,112,2048,163
6037271702,"Census Tract 2717.02, Los Angeles County, California",2053,97,415,93,1638,123
6037271801,"Census Tract 2718.01, Los Angeles County, California",2321,44,370,90,1951,106
6037271802,"Census Tract 2718.02, Los Angeles County, California",2743,80,428,150,2315,183
6037271900,"Census Tract 2719, Los Angeles County, California",2663,93,996,173,1667,176
6037272100,"Census Tract 2721, Los Angeles County, California",1810,86,1135,117,675,127
6037272200,"Census Tract 2722, Los Angeles County, California",2561,131,400,107,2161,161
6037272301,"Census Tract 2723.01, Los Angeles County, California",1378,58,549,85,829,85
6037272302,"Census Tract 2723.02, Los Angeles County, California",1873,82,243,73,1630,103
6037273100,"Census Tract 2731, Los Angeles County, California",891,86,636,92,255,85
6037273200,"Census Tract 2732, Los Angeles County, California",1623,101,443,126,1180,159
6037273300,"Census Tract 2733, Los Angeles County, California",1503,131,269,89,1234,146
6037273400,"Census Tract 2734, Los Angeles County, California",2161,185,374,139,1787,211
6037273500,"Census Tract 2735, Los Angeles County, California",1881,107,332,110,1549,146
6037273600,"Census Tract 2736, Los Angeles County, California",1134,72,663,98,471,91
6037273700,"Census Tract 2737, Los Angeles County, California",1253,78,700,112,553,116
6037273800,"Census Tract 2738, Los Angeles County, California",1575,81,456,99,1119,110
6037273900,"Census Tract 2739, Los Angeles County, California",2430,127,897,173,1533,200
6037274100,"Census Tract 2741, Los Angeles County, California",2115,132,991,132,1124,146
6037274200,"Census Tract 2742, Los Angeles County, California",2461,168,1273,164,1188,220
6037275100,"Census Tract 2751, Los Angeles County, California",1833,77,662,115,1171,125
6037275200,"Census Tract 2752, Los Angeles County, California",1645,81,381,63,1264,105
6037275302,"Census Tract 2753.02, Los Angeles County, California",2483,135,1647,147,836,187
6037275311,"Census Tract 2753.11, Los Angeles County, California",2217,102,1052,121,1165,153
6037275400,"Census Tract 2754, Los Angeles County, California",1110,62,654,77,456,91
6037275510,"Census Tract 2755.10, Los Angeles County, California",981,56,451,117,530,116
6037275520,"Census Tract 2755.20, Los Angeles County, California",648,41,22,19,626,46
6037275601,"Census Tract 2756.01, Los Angeles County, California",4572,159,1451,169,3121,232
6037276000,"Census Tract 2760, Los Angeles County, California",2178,101,1879,121,299,113
6037276100,"Census Tract 2761, Los Angeles County, California",2746,181,625,122,2121,203
6037276400,"Census Tract 2764, Los Angeles County, California",1549,62,1351,98,198,76
6037276500,"Census Tract 2765, Los Angeles County, California",718,86,566,73,152,81
6037276601,"Census Tract 2766.01, Los Angeles County, California",1585,81,1049,104,536,114
6037276602,"Census Tract 2766.02, Los Angeles County, California",4858,216,2415,226,2443,249
6037277000,"Census Tract 2770, Los Angeles County, California",1996,124,1663,147,333,105
6037277100,"Census Tract 2771, Los Angeles County, California",1095,59,967,70,128,67
6037277200,"Census Tract 2772, Los Angeles County, California",1354,110,169,53,1185,121
6037277400,"Census Tract 2774, Los Angeles County, California",800,101,19,16,781,102
6037278000,"Census Tract 2780, Los Angeles County, California",1033,45,509,101,524,109
6037278100,"Census Tract 2781, Los Angeles County, California",1560,73,741,127,819,134
6037291110,"Census Tract 2911.10, Los Angeles County, California",1210,58,445,165,765,175
6037291120,"Census Tract 2911.20, Los Angeles County, California",645,18,253,88,392,92
6037291130,"Census Tract 2911.30, Los Angeles County, California",926,67,793,92,133,66
6037291210,"Census Tract 2912.10, Los Angeles County, California",1400,104,722,105,678,136
6037291220,"Census Tract 2912.20, Los Angeles County, California",1001,60,477,85,524,95
6037291300,"Census Tract 2913, Los Angeles County, California",902,71,711,77,191,73
6037292000,"Census Tract 2920, Los Angeles County, California",1886,86,598,97,1288,128
6037293201,"Census Tract 2932.01, Los Angeles County, California",2128,95,723,143,1405,175
6037293202,"Census Tract 2932.02, Los Angeles County, California",1720,163,302,71,1418,161
6037293301,"Census Tract 2933.01, Los Angeles County, California",1032,26,798,72,234,60
6037293302,"Census Tract 2933.02, Los Angeles County, California",1464,54,1029,93,435,104
6037293304,"Census Tract 2933.04, Los Angeles County, California",1404,66,394,93,1010,117
6037293305,"Census Tract 2933.05, Los Angeles County, California",1702,80,935,122,767,126
6037294110,"Census Tract 2941.10, Los Angeles County, California",1111,43,756,77,355,80
6037294120,"Census Tract 2941.20, Los Angeles County, California",559,55,242,63,317,85
6037294200,"Census Tract 2942, Los Angeles County, California",1256,83,810,109,446,112
6037294300,"Census Tract 2943, Los Angeles County, California",2000,61,1014,121,986,125
6037294410,"Census Tract 2944.10, Los Angeles County, California",1533,72,623,91,910,115
6037294420,"Census Tract 2944.20, Los Angeles County, California",1130,72,321,101,809,109
6037294510,"Census Tract 2945.10, Los Angeles County, California",1039,75,452,99,587,131
6037294520,"Census Tract 2945.20, Los Angeles County, California",901,40,337,80,564,84
6037294610,"Census Tract 2946.10, Los Angeles County, California",1163,61,295,71,868,101
6037294620,"Census Tract 2946.20, Los Angeles County, California",1092,42,483,99,609,100
6037294700,"Census Tract 2947, Los Angeles County, California",849,158,145,69,704,144
6037294810,"Census Tract 2948.10, Los Angeles County, California",1003,48,196,72,807,83
6037294820,"Census Tract 2948.20, Los Angeles County, California",903,42,121,68,782,77
6037294830,"Census Tract 2948.30, Los Angeles County, California",1027,52,216,51,811,78
6037294900,"Census Tract 2949, Los Angeles County, California",449,68,156,62,293,83
6037295101,"Census Tract 2951.01, Los Angeles County, California",2066,145,1742,156,324,140
6037296100,"Census Tract 2961, Los Angeles County, California",76,55,49,35,27,43
6037296210,"Census Tract 2962.10, Los Angeles County, California",909,68,132,59,777,79
6037296220,"Census Tract 2962.20, Los Angeles County, California",1181,90,70,38,1111,96
6037296300,"Census Tract 2963, Los Angeles County, California",1901,93,1290,100,611,107
6037296400,"Census Tract 2964, Los Angeles County, California",2353,96,1968,146,385,126
6037296500,"Census Tract 2965, Los Angeles County, California",1340,61,562,104,778,95
6037296600,"Census Tract 2966, Los Angeles County, California",1856,88,495,105,1361,121
6037296900,"Census Tract 2969, Los Angeles County, California",3169,156,652,177,2517,231
6037297000,"Census Tract 2970, Los Angeles County, California",2299,131,1192,180,1107,197
6037297110,"Census Tract 2971.10, Los Angeles County, California",1474,86,464,176,1010,166
6037297120,"Census Tract 2971.20, Los Angeles County, California",1168,69,288,86,880,109
6037297200,"Census Tract 2972, Los Angeles County, California",3250,141,890,160,2360,218
6037297300,"Census Tract 2973, Los Angeles County, California",1174,59,697,103,477,82
6037297400,"Census Tract 2974, Los Angeles County, California",1588,60,1418,97,170,79
6037297500,"Census Tract 2975, Los Angeles County, California",1394,83,936,107,458,110
6037297600,"Census Tract 2976, Los Angeles County, California",2839,189,984,183,1855,255
6037300100,"Census Tract 3001, Los Angeles County, California",1939,81,1730,114,209,87
6037300200,"Census Tract 3002, Los Angeles County, California",1862,66,1494,109,368,99
6037300300,"Census Tract 3003, Los Angeles County, California",2135,78,1975,87,160,73
6037300400,"Census Tract 3004, Los Angeles County, California",1929,112,1373,157,556,175
6037300501,"Census Tract 3005.01, Los Angeles County, California",1245,73,707,111,538,103
6037300502,"Census Tract 3005.02, Los Angeles County, California",2454,104,679,152,1775,158
6037300600,"Census Tract 3006, Los Angeles County, California",2971,135,1449,211,1522,219
6037300701,"Census Tract 3007.01, Los Angeles County, California",2176,84,1942,112,234,85
6037300702,"Census Tract 3007.02, Los Angeles County, California",2052,118,1935,129,117,71
6037300800,"Census Tract 3008, Los Angeles County, California",2726,140,1606,163,1120,198
6037300901,"Census Tract 3009.01, Los Angeles County, California",2270,75,1974,114,296,109
6037300902,"Census Tract 3009.02, Los Angeles County, California",739,14,708,38,31,33
6037301000,"Census Tract 3010, Los Angeles County, California",1979,112,929,161,1050,153
6037301100,"Census Tract 3011, Los Angeles County, California",2662,140,995,185,1667,210
6037301202,"Census Tract 3012.02, Los Angeles County, California",2704,99,1377,171,1327,187
6037301203,"Census Tract 3012.03, Los Angeles County, California",1848,124,864,113,984,125
6037301204,"Census Tract 3012.04, Los Angeles County, California",2198,82,216,93,1982,113
6037301300,"Census Tract 3013, Los Angeles County, California",735,15,704,32,31,28
6037301400,"Census Tract 3014, Los Angeles County, California",1247,65,1130,86,117,64
6037301501,"Census Tract 3015.01, Los Angeles County, California",585,35,341,72,244,76
6037301502,"Census Tract 3015.02, Los Angeles County, California",2662,52,393,134,2269,153
6037301601,"Census Tract 3016.01, Los Angeles County, California",2349,87,188,88,2161,116
6037301602,"Census Tract 3016.02, Los Angeles County, California",1642,92,544,83,1098,121
6037301701,"Census Tract 3017.01, Los Angeles County, California",1129,79,671,101,458,108
6037301702,"Census Tract 3017.02, Los Angeles County, California",1965,100,554,204,1411,236
6037301800,"Census Tract 3018, Los Angeles County, California",3033,127,756,194,2277,190
6037301900,"Census Tract 3019, Los Angeles County, California",3132,124,1103,185,2029,189
6037302001,"Census Tract 3020.01, Los Angeles County, California",2906,206,371,132,2535,242
6037302002,"Census Tract 3020.02, Los Angeles County, California",1641,80,426,114,1215,131
6037302102,"Census Tract 3021.02, Los Angeles County, California",2687,104,969,161,1718,166
6037302103,"Census Tract 3021.03, Los Angeles County, California",2095,65,250,113,1845,127
6037302104,"Census Tract 3021.04, Los Angeles County, California",1523,66,252,61,1271,91
6037302201,"Census Tract 3022.01, Los Angeles County, California",1526,54,164,72,1362,92
6037302202,"Census Tract 3022.02, Los Angeles County, California",1820,119,223,77,1597,125
6037302301,"Census Tract 3023.01, Los Angeles County, California",1196,63,416,106,780,116
6037302302,"Census Tract 3023.02, Los Angeles County, California",1827,76,239,90,1588,114
6037302400,"Census Tract 3024, Los Angeles County, California",2244,75,305,110,1939,129
6037302501,"Census Tract 3025.01, Los Angeles County, California",2947,112,267,93,2680,143
6037302502,"Census Tract 3025.02, Los Angeles County, California",2569,107,512,165,2057,178
6037310100,"Census Tract 3101, Los Angeles County, California",1955,83,1779,97,176,83
6037310200,"Census Tract 3102, Los Angeles County, California",3724,145,1590,204,2134,220
6037310300,"Census Tract 3103, Los Angeles County, California",1009,53,875,101,134,86
6037310400,"Census Tract 3104, Los Angeles County, California",1256,95,794,97,462,102
6037310500,"Census Tract 3105, Los Angeles County, California",1116,62,280,99,836,115
6037310600,"Census Tract 3106, Los Angeles County, California",3335,110,1129,224,2206,228
6037310701,"Census Tract 3107.01, Los Angeles County, California",1106,64,152,69,954,82
6037310702,"Census Tract 3107.02, Los Angeles County, California",3176,183,413,134,2763,197
6037310703,"Census Tract 3107.03, Los Angeles County, California",2015,100,245,92,1770,133
6037310800,"Census Tract 3108, Los Angeles County, California",2026,104,1071,176,955,171
6037310900,"Census Tract 3109, Los Angeles County, California",2463,106,1736,181,727,188
6037311000,"Census Tract 3110, Los Angeles County, California",1379,67,886,105,493,103
6037311100,"Census Tract 3111, Los Angeles County, California",1315,58,970,96,345,84
6037311200,"Census Tract 3112, Los Angeles County, California",1255,62,737,85,518,95
6037311300,"Census Tract 3113, Los Angeles County, California",1329,117,923,132,406,110
6037311400,"Census Tract 3114, Los Angeles County, California",941,68,499,101,442,95
6037311500,"Census Tract 3115, Los Angeles County, California",2386,98,1112,120,1274,156
6037311600,"Census Tract 3116, Los Angeles County, California",3640,174,1031,167,2609,208
6037311700,"Census Tract 3117, Los Angeles County, California",2431,161,1434,152,997,149
6037311800,"Census Tract 3118, Los Angeles County, California",2648,160,456,123,2192,183
6037320000,"Census Tract 3200, Los Angeles County, California",0,132,0,132,0,132
6037320100,"Census Tract 3201, Los Angeles County, California",1538,114,933,151,605,136
6037320200,"Census Tract 3202, Los Angeles County, California",2594,146,1177,212,1417,197
6037320300,"Census Tract 3203, Los Angeles County, California",1831,122,909,117,922,151
6037400203,"Census Tract 4002.03, Los Angeles County, California",1795,55,1596,84,199,55
6037400204,"Census Tract 4002.04, Los Angeles County, California",2326,69,2222,117,104,97
6037400205,"Census Tract 4002.05, Los Angeles County, California",872,78,844,82,28,27
6037400206,"Census Tract 4002.06, Los Angeles County, California",1845,77,1735,95,110,69
6037400302,"Census Tract 4003.02, Los Angeles County, California",1080,27,771,81,309,86
6037400303,"Census Tract 4003.03, Los Angeles County, California",1252,49,905,109,347,102
6037400304,"Census Tract 4003.04, Los Angeles County, California",2433,131,1332,163,1101,157
6037400401,"Census Tract 4004.01, Los Angeles County, California",1502,56,1378,83,124,62
6037400402,"Census Tract 4004.02, Los Angeles County, California",1302,65,1077,94,225,84
6037400500,"Census Tract 4005, Los Angeles County, California",724,46,650,64,74,48
6037400602,"Census Tract 4006.02, Los Angeles County, California",1446,85,827,146,619,135
6037400603,"Census Tract 4006.03, Los Angeles County, California",1922,98,1327,127,595,119
6037400604,"Census Tract 4006.04, Los Angeles County, California",957,74,716,101,241,87
6037400800,"Census Tract 4008, Los Angeles County, California",950,67,621,69,329,74
6037400900,"Census Tract 4009, Los Angeles County, California",1306,47,981,115,325,104
6037401001,"Census Tract 4010.01, Los Angeles County, California",975,53,928,63,47,40
6037401002,"Census Tract 4010.02, Los Angeles County, California",1532,68,840,112,692,124
6037401101,"Census Tract 4011.01, Los Angeles County, California",1872,89,840,97,1032,111
6037401102,"Census Tract 4011.02, Los Angeles County, California",1131,71,515,112,616,107
6037401201,"Census Tract 4012.01, Los Angeles County, California",1082,31,843,109,239,111
6037401202,"Census Tract 4012.02, Los Angeles County, California",1297,67,1191,79,106,66
6037401203,"Census Tract 4012.03, Los Angeles County, California",1662,78,1289,118,373,111
6037401302,"Census Tract 4013.02, Los Angeles County, California",3234,145,2882,211,352,170
6037401311,"Census Tract 4013.11, Los Angeles County, California",2532,109,1468,175,1064,167
6037401312,"Census Tract 4013.12, Los Angeles County, California",1847,83,1666,121,181,90
6037401500,"Census Tract 4015, Los Angeles County, California",1871,91,1318,135,553,153
6037401601,"Census Tract 4016.01, Los Angeles County, California",2248,89,1901,147,347,131
6037401602,"Census Tract 4016.02, Los Angeles County, California",1942,116,1056,156,886,163
6037401603,"Census Tract 4016.03, Los Angeles County, California",1349,81,1052,108,297,96
6037401701,"Census Tract 4017.01, Los Angeles County, California",1613,103,1272,129,341,81
6037401703,"Census Tract 4017.03, Los Angeles County, California",1359,134,571,103,788,133
6037401704,"Census Tract 4017.04, Los Angeles County, California",1975,72,1029,142,946,136
6037401800,"Census Tract 4018, Los Angeles County, California",2773,138,2142,196,631,164
6037401901,"Census Tract 4019.01, Los Angeles County, California",155,48,24,41,131,36
6037401902,"Census Tract 4019.02, Los Angeles County, California",2721,153,1104,149,1617,168
6037402000,"Census Tract 4020, Los Angeles County, California",2218,175,1261,155,957,172
6037402101,"Census Tract 4021.01, Los Angeles County, California",1037,73,892,97,145,94
6037402102,"Census Tract 4021.02, Los Angeles County, California",1260,86,800,115,460,125
6037402200,"Census Tract 4022, Los Angeles County, California",2155,107,1635,162,520,141
6037402301,"Census Tract 4023.01, Los Angeles County, California",1314,72,775,135,539,130
6037402302,"Census Tract 4023.02, Los Angeles County, California",2120,127,697,136,1423,172
6037402401,"Census Tract 4024.01, Los Angeles County, California",1756,101,1332,127,424,116
6037402402,"Census Tract 4024.02, Los Angeles County, California",2025,136,1101,114,924,157
6037402403,"Census Tract 4024.03, Los Angeles County, California",1062,81,887,101,175,63
6037402404,"Census Tract 4024.04, Los Angeles County, California",33,40,0,132,33,40
6037402501,"Census Tract 4025.01, Los Angeles County, California",1114,87,313,72,801,106
6037402502,"Census Tract 4025.02, Los Angeles County, California",1671,88,554,116,1117,133
6037402600,"Census Tract 4026, Los Angeles County, California",2448,106,1190,155,1258,182
6037402702,"Census Tract 4027.02, Los Angeles County, California",1587,86,444,93,1143,121
6037402703,"Census Tract 4027.03, Los Angeles County, California",1162,70,830,109,332,98
6037402704,"Census Tract 4027.04, Los Angeles County, California",1845,90,1546,144,299,116
6037402801,"Census Tract 4028.01, Los Angeles County, California",1089,79,464,125,625,111
6037402802,"Census Tract 4028.02, Los Angeles County, California",1659,113,551,129,1108,143
6037402901,"Census Tract 4029.01, Los Angeles County, California",1744,64,1354,131,390,125
6037402902,"Census Tract 4029.02, Los Angeles County, California",1400,69,751,82,649,86
6037403000,"Census Tract 4030, Los Angeles County, California",1530,60,1079,132,451,132
6037403200,"Census Tract 4032, Los Angeles County, California",0,132,0,132,0,132
6037403303,"Census Tract 4033.03, Los Angeles County, California",715,87,634,90,81,58
6037403304,"Census Tract 4033.04, Los Angeles County, California",1583,81,1436,95,147,75
6037403305,"Census Tract 4033.05, Los Angeles County, California",741,25,663,50,78,44
6037403312,"Census Tract 4033.12, Los Angeles County, California",1636,57,1287,131,349,113
6037403316,"Census Tract 4033.16, Los Angeles County, California",2585,68,2063,126,522,132
6037403317,"Census Tract 4033.17, Los Angeles County, California",1439,65,1316,81,123,62
6037403318,"Census Tract 4033.18, Los Angeles County, California",1974,80,1798,91,176,77
6037403319,"Census Tract 4033.19, Los Angeles County, California",1574,91,1083,115,491,122
6037403320,"Census Tract 4033.20, Los Angeles County, California",1681,82,1492,103,189,89
6037403321,"Census Tract 4033.21, Los Angeles County, California",1976,51,1730,111,246,106
6037403322,"Census Tract 4033.22, Los Angeles County, California",1224,67,969,96,255,108
6037403323,"Census Tract 4033.23, Los Angeles County, California",1708,46,1528,94,180,83
6037403324,"Census Tract 4033.24, Los Angeles County, California",2223,160,1909,159,314,135
6037403325,"Census Tract 4033.25, Los Angeles County, California",1412,41,1261,90,151,78
6037403401,"Census Tract 4034.01, Los Angeles County, California",1472,83,1330,97,142,59
6037403402,"Census Tract 4034.02, Los Angeles County, California",1036,37,976,60,60,44
6037403403,"Census Tract 4034.03, Los Angeles County, California",1586,49,1583,49,3,16
6037403404,"Census Tract 4034.04, Los Angeles County, California",792,22,745,39,47,37
6037403405,"Census Tract 4034.05, Los Angeles County, California",498,14,498,14,0,132
6037403406,"Census Tract 4034.06, Los Angeles County, California",855,45,580,95,275,81
6037403407,"Census Tract 4034.07, Los Angeles County, California",516,49,479,65,37,42
6037403408,"Census Tract 4034.08, Los Angeles County, California",1857,69,1599,121,258,107
6037403500,"Census Tract 4035, Los Angeles County, California",556,46,329,36,227,60
6037403600,"Census Tract 4036, Los Angeles County, California",2080,95,1535,117,545,99
6037403702,"Census Tract 4037.02, Los Angeles County, California",1118,58,940,90,178,83
6037403703,"Census Tract 4037.03, Los Angeles County, California",1417,82,1366,90,51,41
6037403721,"Census Tract 4037.21, Los Angeles County, California",1561,98,1053,92,508,98
6037403722,"Census Tract 4037.22, Los Angeles County, California",1648,110,563,121,1085,175
6037403801,"Census Tract 4038.01, Los Angeles County, California",1904,91,1213,141,691,132
6037403802,"Census Tract 4038.02, Los Angeles County, California",1937,82,1206,144,731,117
6037403901,"Census Tract 4039.01, Los Angeles County, California",889,36,684,80,205,74
6037403902,"Census Tract 4039.02, Los Angeles County, California",1445,95,1060,121,385,117
6037404000,"Census Tract 4040, Los Angeles County, California",1311,65,1002,72,309,80
6037404100,"Census Tract 4041, Los Angeles County, California",1409,50,1078,93,331,91
6037404200,"Census Tract 4042, Los Angeles County, California",1976,76,932,141,1044,134
6037404301,"Census Tract 4043.01, Los Angeles County, California",1465,95,451,108,1014,113
6037404302,"Census Tract 4043.02, Los Angeles County, California",577,65,433,84,144,55
6037404401,"Census Tract 4044.01, Los Angeles County, California",1031,48,588,89,443,89
6037404402,"Census Tract 4044.02, Los Angeles County, California",1243,69,761,128,482,123
6037404501,"Census Tract 4045.01, Los Angeles County, California",665,53,292,92,373,106
6037404502,"Census Tract 4045.02, Los Angeles County, California",1965,74,1012,115,953,117
6037404600,"Census Tract 4046, Los Angeles County, California",374,32,247,35,127,42
6037404701,"Census Tract 4047.01, Los Angeles County, California",1329,79,951,142,378,121
6037404702,"Census Tract 4047.02, Los Angeles County, California",1519,43,861,122,658,137
6037404703,"Census Tract 4047.03, Los Angeles County, California",756,58,320,52,436,73
6037404801,"Census Tract 4048.01, Los Angeles County, California",1768,66,926,146,842,149
6037404802,"Census Tract 4048.02, Los Angeles County, California",1065,65,627,105,438,110
6037404803,"Census Tract 4048.03, Los Angeles County, California",471,40,399,70,72,58
6037404901,"Census Tract 4049.01, Los Angeles County, California",1208,83,767,129,441,125
6037404902,"Census Tract 4049.02, Los Angeles County, California",847,48,731,80,116,71
6037404903,"Census Tract 4049.03, Los Angeles County, California",661,69,471,90,190,79
6037405001,"Census Tract 4050.01, Los Angeles County, California",1327,72,1081,92,246,91
6037405002,"Census Tract 4050.02, Los Angeles County, California",653,71,471,100,182,96
6037405101,"Census Tract 4051.01, Los Angeles County, California",1186,80,831,136,355,123
6037405102,"Census Tract 4051.02, Los Angeles County, California",1301,58,808,134,493,122
6037405201,"Census Tract 4052.01, Los Angeles County, California",1296,60,726,104,570,97
6037405202,"Census Tract 4052.02, Los Angeles County, California",1218,91,716,130,502,134
6037405203,"Census Tract 4052.03, Los Angeles County, California",767,62,454,95,313,108
6037405300,"Census Tract 4053, Los Angeles County, California",2419,115,1492,137,927,145
6037405400,"Census Tract 4054, Los Angeles County, California",1255,23,1108,89,147,90
6037405500,"Census Tract 4055, Los Angeles County, California",1969,44,1476,110,493,107
6037405600,"Census Tract 4056, Los Angeles County, California",1552,61,1227,78,325,73
6037405700,"Census Tract 4057, Los Angeles County, California",2517,101,1761,210,756,186
6037405800,"Census Tract 4058, Los Angeles County, California",1612,70,1101,125,511,119
6037405900,"Census Tract 4059, Los Angeles County, California",1171,65,892,103,279,86
6037406000,"Census Tract 4060, Los Angeles County, California",1457,63,1129,119,328,112
6037406101,"Census Tract 4061.01, Los Angeles County, California",1044,71,442,104,602,111
6037406102,"Census Tract 4061.02, Los Angeles County, California",2221,91,590,118,1631,147
6037406200,"Census Tract 4062, Los Angeles County, California",1748,106,601,97,1147,117
6037406300,"Census Tract 4063, Los Angeles County, California",1550,103,1163,113,387,118
6037406402,"Census Tract 4064.02, Los Angeles County, California",606,27,566,64,40,45
6037406411,"Census Tract 4064.11, Los Angeles County, California",500,53,418,68,82,50
6037406412,"Census Tract 4064.12, Los Angeles County, California",805,25,623,61,182,67
6037406500,"Census Tract 4065, Los Angeles County, California",2095,88,1184,137,911,149
6037406601,"Census Tract 4066.01, Los Angeles County, California",1473,62,1241,106,232,82
6037406602,"Census Tract 4066.02, Los Angeles County, California",1300,71,930,87,370,112
6037406700,"Census Tract 4067, Los Angeles County, California",2493,120,1435,175,1058,169
6037406800,"Census Tract 4068, Los Angeles County, California",1230,67,1033,100,197,97
6037406900,"Census Tract 4069, Los Angeles County, California",2098,69,1431,152,667,153
6037407001,"Census Tract 4070.01, Los Angeles County, California",1171,72,892,89,279,86
6037407002,"Census Tract 4070.02, Los Angeles County, California",776,34,618,83,158,76
6037407101,"Census Tract 4071.01, Los Angeles County, California",1225,62,914,85,311,87
6037407102,"Census Tract 4071.02, Los Angeles County, California",1292,65,899,97,393,98
6037407200,"Census Tract 4072, Los Angeles County, California",1589,84,1246,115,343,100
6037407301,"Census Tract 4073.01, Los Angeles County, California",1014,75,901,92,113,75
6037407302,"Census Tract 4073.02, Los Angeles County, California",702,47,560,77,142,77
6037407400,"Census Tract 4074, Los Angeles County, California",499,33,435,49,64,48
6037407500,"Census Tract 4075, Los Angeles County, California",1868,55,1233,120,635,117
6037407600,"Census Tract 4076, Los Angeles County, California",2131,118,996,141,1135,146
6037407701,"Census Tract 4077.01, Los Angeles County, California",1223,64,507,88,716,96
6037407702,"Census Tract 4077.02, Los Angeles County, California",1738,83,1262,140,476,133
6037407800,"Census Tract 4078, Los Angeles County, California",1871,34,1458,133,413,127
6037407900,"Census Tract 4079, Los Angeles County, California",1444,58,1128,128,316,112
6037408001,"Census Tract 4080.01, Los Angeles County, California",2588,104,1704,173,884,174
6037408002,"Census Tract 4080.02, Los Angeles County, California",2116,84,1479,179,637,175
6037408101,"Census Tract 4081.01, Los Angeles County, California",2271,118,1291,177,980,173
6037408102,"Census Tract 4081.02, Los Angeles County, California",1902,28,1317,141,585,144
6037408132,"Census Tract 4081.32, Los Angeles County, California",2056,65,1461,177,595,169
6037408133,"Census Tract 4081.33, Los Angeles County, California",1480,93,631,106,849,119
6037408134,"Census Tract 4081.34, Los Angeles County, California",891,27,814,57,77,50
6037408135,"Census Tract 4081.35, Los Angeles County, California",1125,59,716,119,409,119
6037408202,"Census Tract 4082.02, Los Angeles County, California",491,51,275,81,216,80
6037408211,"Census Tract 4082.11, Los Angeles County, California",1746,70,719,119,1027,145
6037408212,"Census Tract 4082.12, Los Angeles County, California",1224,60,1022,103,202,94
6037408301,"Census Tract 4083.01, Los Angeles County, California",1183,86,798,128,385,118
6037408302,"Census Tract 4083.02, Los Angeles County, California",1066,23,866,93,200,88
6037408303,"Census Tract 4083.03, Los Angeles County, California",1148,52,986,114,162,92
6037408401,"Census Tract 4084.01, Los Angeles County, California",1184,63,681,114,503,113
6037408402,"Census Tract 4084.02, Los Angeles County, California",1731,94,1496,137,235,122
6037408501,"Census Tract 4085.01, Los Angeles County, California",700,68,430,90,270,90
6037408502,"Census Tract 4085.02, Los Angeles County, California",2163,153,1667,163,496,140
6037408503,"Census Tract 4085.03, Los Angeles County, California",1814,102,1659,132,155,108
6037408601,"Census Tract 4086.01, Los Angeles County, California",1869,75,1484,150,385,135
6037408623,"Census Tract 4086.23, Los Angeles County, California",1001,25,688,110,313,105
6037408624,"Census Tract 4086.24, Los Angeles County, California",1014,23,837,81,177,86
6037408625,"Census Tract 4086.25, Los Angeles County, California",1248,88,1089,118,159,72
6037408626,"Census Tract 4086.26, Los Angeles County, California",1601,93,813,101,788,120
6037408627,"Census Tract 4086.27, Los Angeles County, California",902,41,770,76,132,66
6037408628,"Census Tract 4086.28, Los Angeles County, California",1835,54,1335,110,500,105
6037408629,"Census Tract 4086.29, Los Angeles County, California",913,76,843,79,70,43
6037408703,"Census Tract 4087.03, Los Angeles County, California",1879,66,1726,109,153,99
6037408704,"Census Tract 4087.04, Los Angeles County, California",934,77,506,84,428,92
6037408705,"Census Tract 4087.05, Los Angeles County, California",1490,63,1107,108,383,97
6037408706,"Census Tract 4087.06, Los Angeles County, California",471,11,448,30,23,25
6037408721,"Census Tract 4087.21, Los Angeles County, California",2210,77,647,148,1563,150
6037408722,"Census Tract 4087.22, Los Angeles County, California",1197,61,1080,79,117,57
6037408800,"Census Tract 4088, Los Angeles County, California",1222,74,214,82,1008,103
6037430001,"Census Tract 4300.01, Los Angeles County, California",1453,104,1355,108,98,53
6037430002,"Census Tract 4300.02, Los Angeles County, California",2166,144,1487,198,679,183
6037430101,"Census Tract 4301.01, Los Angeles County, California",1574,128,755,113,819,126
6037430102,"Census Tract 4301.02, Los Angeles County, California",1237,88,889,124,348,115
6037430200,"Census Tract 4302, Los Angeles County, California",381,64,285,60,96,43
6037430301,"Census Tract 4303.01, Los Angeles County, California",1672,86,1465,97,207,66
6037430302,"Census Tract 4303.02, Los Angeles County, California",2475,126,1596,147,879,184
6037430400,"Census Tract 4304, Los Angeles County, California",1430,86,1241,105,189,81
6037430501,"Census Tract 4305.01, Los Angeles County, California",1717,112,1334,124,383,95
6037430502,"Census Tract 4305.02, Los Angeles County, California",2849,118,1608,199,1241,219
6037430600,"Census Tract 4306, Los Angeles County, California",1371,97,1347,99,24,26
6037430701,"Census Tract 4307.01, Los Angeles County, California",1941,58,1292,124,649,122
6037430721,"Census Tract 4307.21, Los Angeles County, California",1192,78,678,103,514,108
6037430723,"Census Tract 4307.23, Los Angeles County, California",1679,91,514,126,1165,134
6037430724,"Census Tract 4307.24, Los Angeles County, California",1954,56,536,108,1418,115
6037430801,"Census Tract 4308.01, Los Angeles County, California",2249,106,876,167,1373,201
6037430802,"Census Tract 4308.02, Los Angeles County, California",1386,48,1071,103,315,87
6037430803,"Census Tract 4308.03, Los Angeles County, California",1724,69,1522,97,202,66
6037430900,"Census Tract 4309, Los Angeles County, California",3387,166,1304,206,2083,234
6037431001,"Census Tract 4310.01, Los Angeles County, California",2726,138,881,199,1845,203
6037431002,"Census Tract 4310.02, Los Angeles County, California",1249,84,805,77,444,89
6037431100,"Census Tract 4311, Los Angeles County, California",2057,118,827,151,1230,166
6037431200,"Census Tract 4312, Los Angeles County, California",1496,40,1137,97,359,96
6037431300,"Census Tract 4313, Los Angeles County, California",839,49,571,81,268,74
6037431400,"Census Tract 4314, Los Angeles County, California",1385,91,1118,105,267,98
6037431500,"Census Tract 4315, Los Angeles County, California",2948,149,1944,201,1004,168
6037431600,"Census Tract 4316, Los Angeles County, California",1189,68,970,93,219,85
6037431700,"Census Tract 4317, Los Angeles County, California",1951,122,1540,143,411,128
6037431800,"Census Tract 4318, Los Angeles County, California",1676,108,1099,136,577,118
6037431900,"Census Tract 4319, Los Angeles County, California",1487,94,851,105,636,128
6037432000,"Census Tract 4320, Los Angeles County, California",2473,114,1525,195,948,210
6037432101,"Census Tract 4321.01, Los Angeles County, California",1458,73,1105,103,353,107
6037432102,"Census Tract 4321.02, Los Angeles County, California",1837,82,1427,133,410,131
6037432201,"Census Tract 4322.01, Los Angeles County, California",1250,75,835,103,415,88
6037432202,"Census Tract 4322.02, Los Angeles County, California",1236,50,792,114,444,119
6037432300,"Census Tract 4323, Los Angeles County, California",1167,52,686,104,481,113
6037432401,"Census Tract 4324.01, Los Angeles County, California",1021,63,494,119,527,130
6037432402,"Census Tract 4324.02, Los Angeles County, California",1729,96,544,101,1185,144
6037432500,"Census Tract 4325, Los Angeles County, California",2253,145,1489,227,764,206
6037432601,"Census Tract 4326.01, Los Angeles County, California",1594,139,823,129,771,157
6037432602,"Census Tract 4326.02, Los Angeles County, California",1204,66,756,127,448,130
6037432700,"Census Tract 4327, Los Angeles County, California",1262,93,704,126,558,136
6037432801,"Census Tract 4328.01, Los Angeles County, California",795,49,228,83,567,87
6037432802,"Census Tract 4328.02, Los Angeles County, California",1534,76,163,57,1371,84
6037432901,"Census Tract 4329.01, Los Angeles County, California",1274,47,660,106,614,101
6037432902,"Census Tract 4329.02, Los Angeles County, California",941,34,718,94,223,96
6037433100,"Census Tract 4331, Los Angeles County, California",1927,69,692,130,1235,134
6037433200,"Census Tract 4332, Los Angeles County, California",1634,87,678,95,956,104
6037433301,"Census Tract 4333.01, Los Angeles County, California",2489,124,725,160,1764,202
6037433302,"Census Tract 4333.02, Los Angeles County, California",427,42,169,55,258,64
6037433303,"Census Tract 4333.03, Los Angeles County, California",1504,92,661,113,843,124
6037433401,"Census Tract 4334.01, Los Angeles County, California",724,74,301,88,423,93
6037433402,"Census Tract 4334.02, Los Angeles County, California",1159,63,323,94,836,105
6037433403,"Census Tract 4334.03, Los Angeles County, California",1296,65,228,73,1068,89
6037433501,"Census Tract 4335.01, Los Angeles County, California",553,47,139,81,414,80
6037433502,"Census Tract 4335.02, Los Angeles County, California",1716,87,575,110,1141,127
6037433601,"Census Tract 4336.01, Los Angeles County, California",1228,81,734,110,494,103
6037433602,"Census Tract 4336.02, Los Angeles County, California",815,37,412,89,403,90
6037433700,"Census Tract 4337, Los Angeles County, California",850,71,616,97,234,94
6037433801,"Census Tract 4338.01, Los Angeles County, California",1389,77,418,92,971,127
6037433802,"Census Tract 4338.02, Los Angeles County, California",727,52,526,101,201,85
6037433901,"Census Tract 4339.01, Los Angeles County, California",1231,93,277,103,954,109
6037433902,"Census Tract 4339.02, Los Angeles County, California",1005,42,531,81,474,89
6037434001,"Census Tract 4340.01, Los Angeles County, California",1059,66,594,100,465,100
6037434002,"Census Tract 4340.02, Los Angeles County, California",1770,60,754,132,1016,134
6037460000,"Census Tract 4600, Los Angeles County, California",1751,73,1575,105,176,79
6037460100,"Census Tract 4601, Los Angeles County, California",2388,39,2104,115,284,109
6037460200,"Census Tract 4602, Los Angeles County, California",2035,96,1591,148,444,128
6037460301,"Census Tract 4603.01, Los Angeles County, California",1705,31,1529,89,176,81
6037460302,"Census Tract 4603.02, Los Angeles County, California",1359,46,1099,112,260,103
6037460400,"Census Tract 4604, Los Angeles County, California",333,19,277,39,56,36
6037460501,"Census Tract 4605.01, Los Angeles County, California",1831,84,1751,111,80,65
6037460502,"Census Tract 4605.02, Los Angeles County, California",1450,88,1334,97,116,61
6037460600,"Census Tract 4606, Los Angeles County, California",1521,61,1400,88,121,67
6037460700,"Census Tract 4607, Los Angeles County, California",1653,100,1576,106,77,49
6037460800,"Census Tract 4608, Los Angeles County, California",1353,65,1266,99,87,76
6037460900,"Census Tract 4609, Los Angeles County, California",2073,89,1218,157,855,149
6037461000,"Census Tract 4610, Los Angeles County, California",1713,72,996,132,717,137
6037461100,"Census Tract 4611, Los Angeles County, California",1541,79,913,118,628,119
6037461200,"Census Tract 4612, Los Angeles County, California",1645,72,1363,134,282,122
6037461300,"Census Tract 4613, Los Angeles County, California",2395,123,1487,130,908,153
6037461400,"Census Tract 4614, Los Angeles County, California",1372,86,553,97,819,119
6037461500,"Census Tract 4615, Los Angeles County, California",2806,139,1332,156,1474,185
6037461600,"Census Tract 4616, Los Angeles County, California",1801,71,799,136,1002,145
6037461700,"Census Tract 4617, Los Angeles County, California",708,51,635,79,73,61
6037461900,"Census Tract 4619, Los Angeles County, California",2447,196,349,148,2098,208
6037462000,"Census Tract 4620, Los Angeles County, California",2449,99,645,162,1804,187
6037462100,"Census Tract 4621, Los Angeles County, California",1843,87,608,106,1235,130
6037462200,"Census Tract 4622, Los Angeles County, California",3195,162,328,92,2867,166
6037462300,"Census Tract 4623, Los Angeles County, California",3142,151,663,121,2479,212
6037462400,"Census Tract 4624, Los Angeles County, California",1628,80,1092,129,536,119
6037462500,"Census Tract 4625, Los Angeles County, California",2351,131,1639,155,712,160
6037462600,"Census Tract 4626, Los Angeles County, California",927,27,748,65,179,59
6037462700,"Census Tract 4627, Los Angeles County, California",2078,159,743,148,1335,201
6037462800,"Census Tract 4628, Los Angeles County, California",1159,73,446,104,713,118
6037462900,"Census Tract 4629, Los Angeles County, California",1390,93,1190,101,200,75
6037463000,"Census Tract 4630, Los Angeles County, California",833,58,624,91,209,107
6037463101,"Census Tract 4631.01, Los Angeles County, California",854,64,495,93,359,94
6037463102,"Census Tract 4631.02, Los Angeles County, California",1127,61,857,97,270,89
6037463200,"Census Tract 4632, Los Angeles County, California",1456,85,719,85,737,104
6037463300,"Census Tract 4633, Los Angeles County, California",766,86,451,77,315,69
6037463400,"Census Tract 4634, Los Angeles County, California",2695,127,999,143,1696,169
6037463500,"Census Tract 4635, Los Angeles County, California",2560,171,912,190,1648,200
6037463600,"Census Tract 4636, Los Angeles County, California",6142,254,1552,235,4590,288
6037463700,"Census Tract 4637, Los Angeles County, California",882,70,615,104,267,93
6037463800,"Census Tract 4638, Los Angeles County, California",1630,86,1490,106,140,67
6037463900,"Census Tract 4639, Los Angeles County, California",1525,89,964,105,561,102
6037464000,"Census Tract 4640, Los Angeles County, California",2724,149,1543,199,1181,193
6037464100,"Census Tract 4641, Los Angeles County, California",2343,134,2238,142,105,73
6037464200,"Census Tract 4642, Los Angeles County, California",1888,117,1760,121,128,62
6037480002,"Census Tract 4800.02, Los Angeles County, California",1113,50,981,76,132,71
6037480011,"Census Tract 4800.11, Los Angeles County, California",1768,109,766,129,1002,162
6037480012,"Census Tract 4800.12, Los Angeles County, California",1726,96,962,110,764,143
6037480101,"Census Tract 4801.01, Los Angeles County, California",1336,77,782,113,554,110
6037480102,"Census Tract 4801.02, Los Angeles County, California",1340,95,815,119,525,112
6037480201,"Census Tract 4802.01, Los Angeles County, California",1359,89,1184,103,175,69
6037480202,"Census Tract 4802.02, Los Angeles County, California",870,51,785,55,85,44
6037480301,"Census Tract 4803.01, Los Angeles County, California",3076,121,537,162,2539,210
6037480302,"Census Tract 4803.02, Los Angeles County, California",1692,87,794,158,898,164
6037480400,"Census Tract 4804, Los Angeles County, California",2302,96,1171,193,1131,200
6037480500,"Census Tract 4805, Los Angeles County, California",2018,95,1228,136,790,132
6037480600,"Census Tract 4806, Los Angeles County, California",3180,149,889,142,2291,188
6037480702,"Census Tract 4807.02, Los Angeles County, California",1604,59,1196,105,408,93
6037480703,"Census Tract 4807.03, Los Angeles County, California",1236,53,765,114,471,109
6037480704,"Census Tract 4807.04, Los Angeles County, California",1794,105,574,86,1220,121
6037480802,"Census Tract 4808.02, Los Angeles County, California",1088,31,684,105,404,108
6037480803,"Census Tract 4808.03, Los Angeles County, California",1265,82,882,118,383,110
6037480804,"Census Tract 4808.04, Los Angeles County, California",1849,108,449,117,1400,133
6037480901,"Census Tract 4809.01, Los Angeles County, California",1485,149,402,110,1083,165
6037480902,"Census Tract 4809.02, Los Angeles County, California",1409,68,384,111,1025,128
6037480903,"Census Tract 4809.03, Los Angeles County, California",988,63,482,111,506,109
6037481001,"Census Tract 4810.01, Los Angeles County, California",1251,99,476,107,775,134
6037481002,"Census Tract 4810.02, Los Angeles County, California",1962,88,620,137,1342,156
6037481101,"Census Tract 4811.01, Los Angeles County, California",1429,77,283,69,1146,105
6037481102,"Census Tract 4811.02, Los Angeles County, California",1331,93,203,74,1128,107
6037481103,"Census Tract 4811.03, Los Angeles County, California",1484,84,813,114,671,136
6037481201,"Census Tract 4812.01, Los Angeles County, California",1139,105,557,101,582,110
6037481202,"Census Tract 4812.02, Los Angeles County, California",1876,138,1004,135,872,157
6037481300,"Census Tract 4813, Los Angeles County, California",806,61,516,90,290,82
6037481401,"Census Tract 4814.01, Los Angeles County, California",1896,82,809,119,1087,116
6037481402,"Census Tract 4814.02, Los Angeles County, California",2074,99,1035,189,1039,193
6037481500,"Census Tract 4815, Los Angeles County, California",1544,54,1038,126,506,129
6037481602,"Census Tract 4816.02, Los Angeles County, California",2661,106,1035,181,1626,181
6037481603,"Census Tract 4816.03, Los Angeles County, California",1200,94,487,108,713,132
6037481604,"Census Tract 4816.04, Los Angeles County, California",1267,91,407,89,860,116
6037481711,"Census Tract 4817.11, Los Angeles County, California",1389,83,281,83,1108,106
6037481712,"Census Tract 4817.12, Los Angeles County, California",1534,111,537,127,997,144
6037481713,"Census Tract 4817.13, Los Angeles County, California",825,76,359,90,466,100
6037481714,"Census Tract 4817.14, Los Angeles County, California",905,59,235,81,670,95
6037481800,"Census Tract 4818, Los Angeles County, California",917,60,726,99,191,93
6037481901,"Census Tract 4819.01, Los Angeles County, California",2052,83,1412,142,640,128
6037481902,"Census Tract 4819.02, Los Angeles County, California",1078,46,713,94,365,99
6037482001,"Census Tract 4820.01, Los Angeles County, California",969,63,795,90,174,76
6037482002,"Census Tract 4820.02, Los Angeles County, California",2448,118,1368,170,1080,183
6037482101,"Census Tract 4821.01, Los Angeles County, California",1535,70,697,105,838,109
6037482102,"Census Tract 4821.02, Los Angeles County, California",988,32,712,103,276,104
6037482201,"Census Tract 4822.01, Los Angeles County, California",1214,59,561,116,653,114
6037482202,"Census Tract 4822.02, Los Angeles County, California",1555,85,707,126,848,139
6037482301,"Census Tract 4823.01, Los Angeles County, California",1293,67,536,99,757,117
6037482303,"Census Tract 4823.03, Los Angeles County, California",1514,82,375,86,1139,112
6037482304,"Census Tract 4823.04, Los Angeles County, California",912,108,209,68,703,136
6037482401,"Census Tract 4824.01, Los Angeles County, California",944,51,454,87,490,97
6037482402,"Census Tract 4824.02, Los Angeles County, California",2014,96,1235,166,779,161
6037482502,"Census Tract 4825.02, Los Angeles County, California",827,53,442,97,385,104
6037482503,"Census Tract 4825.03, Los Angeles County, California",1017,84,357,89,660,110
6037482521,"Census Tract 4825.21, Los Angeles County, California",1416,75,897,126,519,119
6037482522,"Census Tract 4825.22, Los Angeles County, California",1528,72,1189,112,339,107
6037482600,"Census Tract 4826, Los Angeles County, California",2333,107,1823,161,510,171
6037482701,"Census Tract 4827.01, Los Angeles County, California",1366,55,741,130,625,130
6037482702,"Census Tract 4827.02, Los Angeles County, California",839,29,636,110,203,99
6037482800,"Census Tract 4828, Los Angeles County, California",1335,73,1087,89,248,74
6037500100,"Census Tract 5001, Los Angeles County, California",1201,114,1187,116,14,21
6037500201,"Census Tract 5002.01, Los Angeles County, California",1949,91,1831,121,118,82
6037500202,"Census Tract 5002.02, Los Angeles County, California",1511,71,1353,108,158,80
6037500300,"Census Tract 5003, Los Angeles County, California",1051,33,899,80,152,79
6037500401,"Census Tract 5004.01, Los Angeles County, California",2243,107,1850,178,393,149
6037500402,"Census Tract 5004.02, Los Angeles County, California",1101,94,502,88,599,114
6037500500,"Census Tract 5005, Los Angeles County, California",854,70,645,108,209,88
6037500600,"Census Tract 5006, Los Angeles County, California",1327,78,1036,98,291,88
6037500700,"Census Tract 5007, Los Angeles County, California",1613,102,1147,134,466,120
6037500800,"Census Tract 5008, Los Angeles County, California",1371,76,1008,116,363,117
6037500900,"Census Tract 5009, Los Angeles County, California",1578,61,822,109,756,110
6037501000,"Census Tract 5010, Los Angeles County, California",2067,88,1601,156,466,133
6037501200,"Census Tract 5012, Los Angeles County, California",1465,50,1015,135,450,123
6037501300,"Census Tract 5013, Los Angeles County, California",2345,112,1509,159,836,166
6037501400,"Census Tract 5014, Los Angeles County, California",1230,57,466,119,764,135
6037501501,"Census Tract 5015.01, Los Angeles County, California",754,56,673,75,81,56
6037501503,"Census Tract 5015.03, Los Angeles County, California",1709,175,328,78,1381,179
6037501504,"Census Tract 5015.04, Los Angeles County, California",1517,75,184,60,1333,85
6037501600,"Census Tract 5016, Los Angeles County, California",2220,83,1502,160,718,148
6037501700,"Census Tract 5017, Los Angeles County, California",1221,58,926,99,295,89
6037501801,"Census Tract 5018.01, Los Angeles County, California",2251,101,346,76,1905,120
6037501802,"Census Tract 5018.02, Los Angeles County, California",1114,50,525,86,589,88
6037501900,"Census Tract 5019, Los Angeles County, California",1325,36,1162,87,163,77
6037502001,"Census Tract 5020.01, Los Angeles County, California",1160,67,842,107,318,96
6037502002,"Census Tract 5020.02, Los Angeles County, California",1731,76,939,119,792,134
6037502100,"Census Tract 5021, Los Angeles County, California",1550,60,986,115,564,117
6037502200,"Census Tract 5022, Los Angeles County, California",1801,76,1236,118,565,113
6037502301,"Census Tract 5023.01, Los Angeles County, California",1402,23,1095,138,307,135
6037502302,"Census Tract 5023.02, Los Angeles County, California",704,55,234,60,470,76
6037502401,"Census Tract 5024.01, Los Angeles County, California",1261,44,952,101,309,91
6037502402,"Census Tract 5024.02, Los Angeles County, California",1038,42,799,105,239,95
6037502500,"Census Tract 5025, Los Angeles County, California",1100,52,525,110,575,104
6037502601,"Census Tract 5026.01, Los Angeles County, California",1757,76,1464,124,293,115
6037502602,"Census Tract 5026.02, Los Angeles County, California",1259,80,598,92,661,111
6037502700,"Census Tract 5027, Los Angeles County, California",1956,118,1204,179,752,145
6037502800,"Census Tract 5028, Los Angeles County, California",2630,174,1459,175,1171,167
6037502901,"Census Tract 5029.01, Los Angeles County, California",1404,56,1142,107,262,117
6037502902,"Census Tract 5029.02, Los Angeles County, California",913,45,393,94,520,87
6037503000,"Census Tract 5030, Los Angeles County, California",1106,92,509,115,597,126
6037503101,"Census Tract 5031.01, Los Angeles County, California",2054,100,1038,160,1016,177
6037503102,"Census Tract 5031.02, Los Angeles County, California",1714,55,1192,135,522,129
6037503201,"Census Tract 5032.01, Los Angeles County, California",1153,16,1056,67,97,67
6037503202,"Census Tract 5032.02, Los Angeles County, California",1265,46,900,65,365,67
6037503301,"Census Tract 5033.01, Los Angeles County, California",966,64,785,88,181,88
6037503302,"Census Tract 5033.02, Los Angeles County, California",1908,41,929,140,979,138
6037503401,"Census Tract 5034.01, Los Angeles County, California",2133,116,1570,148,563,127
6037503402,"Census Tract 5034.02, Los Angeles County, California",1285,42,1064,88,221,79
6037503501,"Census Tract 5035.01, Los Angeles County, California",1967,60,1193,109,774,118
6037503502,"Census Tract 5035.02, Los Angeles County, California",1249,33,1045,87,204,83
6037503601,"Census Tract 5036.01, Los Angeles County, California",1207,74,1085,94,122,62
6037503602,"Census Tract 5036.02, Los Angeles County, California",1219,65,1163,66,56,39
6037503701,"Census Tract 5037.01, Los Angeles County, California",1661,37,908,91,753,97
6037503702,"Census Tract 5037.02, Los Angeles County, California",1612,69,1169,88,443,101
6037503703,"Census Tract 5037.03, Los Angeles County, California",2969,114,2326,148,643,120
6037503801,"Census Tract 5038.01, Los Angeles County, California",1205,82,990,88,215,78
6037503802,"Census Tract 5038.02, Los Angeles County, California",1591,68,1285,119,306,101
6037503901,"Census Tract 5039.01, Los Angeles County, California",831,31,730,79,101,68
6037503902,"Census Tract 5039.02, Los Angeles County, California",1445,50,1330,87,115,69
6037504001,"Census Tract 5040.01, Los Angeles County, California",1116,108,798,92,318,88
6037504002,"Census Tract 5040.02, Los Angeles County, California",1651,77,1295,144,356,126
6037504101,"Census Tract 5041.01, Los Angeles County, California",1459,45,1005,106,454,106
6037504102,"Census Tract 5041.02, Los Angeles County, California",0,132,0,132,0,132
6037530003,"Census Tract 5300.03, Los Angeles County, California",919,52,832,57,87,45
6037530004,"Census Tract 5300.04, Los Angeles County, California",1119,69,708,70,411,85
6037530005,"Census Tract 5300.05, Los Angeles County, California",1350,77,1148,96,202,78
6037530006,"Census Tract 5300.06, Los Angeles County, California",1384,97,326,95,1058,111
6037530101,"Census Tract 5301.01, Los Angeles County, California",1570,89,371,90,1199,111
6037530102,"Census Tract 5301.02, Los Angeles County, California",1579,89,823,108,756,107
6037530202,"Census Tract 5302.02, Los Angeles County, California",1158,75,689,111,469,127
6037530203,"Census Tract 5302.03, Los Angeles County, California",1048,55,314,68,734,76
6037530204,"Census Tract 5302.04, Los Angeles County, California",1065,86,429,110,636,123
6037530301,"Census Tract 5303.01, Los Angeles County, California",629,51,335,66,294,75
6037530302,"Census Tract 5303.02, Los Angeles County, California",1747,80,659,117,1088,138
6037530400,"Census Tract 5304, Los Angeles County, California",1239,55,561,89,678,99
6037530500,"Census Tract 5305, Los Angeles County, California",1192,48,464,96,728,102
6037530601,"Census Tract 5306.01, Los Angeles County, California",794,67,345,82,449,87
6037530602,"Census Tract 5306.02, Los Angeles County, California",316,77,184,88,132,59
6037530700,"Census Tract 5307, Los Angeles County, California",467,86,196,62,271,86
6037530801,"Census Tract 5308.01, Los Angeles County, California",1411,83,591,114,820,121
6037530802,"Census Tract 5308.02, Los Angeles County, California",822,76,499,76,323,81
6037530901,"Census Tract 5309.01, Los Angeles County, California",848,69,247,79,601,105
6037530902,"Census Tract 5309.02, Los Angeles County, California",1045,79,352,92,693,107
6037531000,"Census Tract 5310, Los Angeles County, California",1270,63,434,113,836,123
6037531101,"Census Tract 5311.01, Los Angeles County, California",1208,86,469,121,739,134
6037531102,"Census Tract 5311.02, Los Angeles County, California",780,52,201,78,579,84
6037531201,"Census Tract 5312.01, Los Angeles County, California",1220,73,400,79,820,111
6037531202,"Census Tract 5312.02, Los Angeles County, California",1157,62,244,90,913,102
6037531301,"Census Tract 5313.01, Los Angeles County, California",1254,80,337,96,917,112
6037531302,"Census Tract 5313.02, Los Angeles County, California",1439,80,447,126,992,134
6037531501,"Census Tract 5315.01, Los Angeles County, California",1845,78,608,123,1237,132
6037531502,"Census Tract 5315.02, Los Angeles County, California",809,29,195,81,614,83
6037531602,"Census Tract 5316.02, Los Angeles County, California",1143,58,260,90,883,102
6037531603,"Census Tract 5316.03, Los Angeles County, California",866,45,327,74,539,76
6037531604,"Census Tract 5316.04, Los Angeles County, California",916,46,269,111,647,116
6037531701,"Census Tract 5317.01, Los Angeles County, California",1396,66,581,139,815,151
6037531702,"Census Tract 5317.02, Los Angeles County, California",1229,83,267,94,962,112
6037531800,"Census Tract 5318, Los Angeles County, California",1216,79,522,123,694,119
6037531901,"Census Tract 5319.01, Los Angeles County, California",1696,81,618,109,1078,138
6037531902,"Census Tract 5319.02, Los Angeles County, California",1122,53,451,116,671,122
6037532001,"Census Tract 5320.01, Los Angeles County, California",1081,35,363,79,718,83
6037532002,"Census Tract 5320.02, Los Angeles County, California",854,74,385,82,469,92
6037532101,"Census Tract 5321.01, Los Angeles County, California",1714,67,383,112,1331,130
6037532102,"Census Tract 5321.02, Los Angeles County, California",926,75,664,81,262,64
6037532200,"Census Tract 5322, Los Angeles County, California",1725,72,573,107,1152,123
6037532302,"Census Tract 5323.02, Los Angeles County, California",1097,94,614,119,483,120
6037532303,"Census Tract 5323.03, Los Angeles County, California",1226,113,612,107,614,132
6037532304,"Census Tract 5323.04, Los Angeles County, California",952,84,442,109,510,109
6037532400,"Census Tract 5324, Los Angeles County, California",23,11,4,4,19,11
6037532500,"Census Tract 5325, Los Angeles County, California",1072,92,357,93,715,123
6037532603,"Census Tract 5326.03, Los Angeles County, California",805,60,205,72,600,76
6037532604,"Census Tract 5326.04, Los Angeles County, California",698,39,171,65,527,68
6037532605,"Census Tract 5326.05, Los Angeles County, California",1084,69,253,72,831,100
6037532606,"Census Tract 5326.06, Los Angeles County, California",1197,96,106,65,1091,111
6037532700,"Census Tract 5327, Los Angeles County, California",570,60,130,67,440,80
6037532800,"Census Tract 5328, Los Angeles County, California",1002,90,289,80,713,116
6037532900,"Census Tract 5329, Los Angeles County, California",1557,75,386,90,1171,101
6037533000,"Census Tract 5330, Los Angeles County, California",1545,89,536,125,1009,136
6037533103,"Census Tract 5331.03, Los Angeles County, California",866,63,91,49,775,73
6037533104,"Census Tract 5331.04, Los Angeles County, California",1225,94,131,68,1094,116
6037533105,"Census Tract 5331.05, Los Angeles County, California",629,58,140,52,489,66
6037533106,"Census Tract 5331.06, Los Angeles County, California",396,53,184,62,212,60
6037533107,"Census Tract 5331.07, Los Angeles County, California",1006,62,288,87,718,101
6037533201,"Census Tract 5332.01, Los Angeles County, California",685,48,112,66,573,76
6037533202,"Census Tract 5332.02, Los Angeles County, California",637,54,357,105,280,108
6037533203,"Census Tract 5332.03, Los Angeles County, California",457,60,102,59,355,72
6037533300,"Census Tract 5333, Los Angeles County, California",835,68,156,46,679,80
6037533401,"Census Tract 5334.01, Los Angeles County, California",1224,58,453,89,771,105
6037533402,"Census Tract 5334.02, Los Angeles County, California",1041,57,184,77,857,90
6037533403,"Census Tract 5334.03, Los Angeles County, California",688,87,303,102,385,109
6037533501,"Census Tract 5335.01, Los Angeles County, California",724,77,130,63,594,104
6037533502,"Census Tract 5335.02, Los Angeles County, California",576,41,249,83,327,82
6037533503,"Census Tract 5335.03, Los Angeles County, California",464,65,180,74,284,86
6037533601,"Census Tract 5336.01, Los Angeles County, California",1070,133,227,75,843,155
6037533602,"Census Tract 5336.02, Los Angeles County, California",1461,129,244,89,1217,158
6037533603,"Census Tract 5336.03, Los Angeles County, California",1677,109,426,102,1251,138
6037533701,"Census Tract 5337.01, Los Angeles County, California",1038,64,267,76,771,89
6037533702,"Census Tract 5337.02, Los Angeles County, California",800,70,233,81,567,94
6037533703,"Census Tract 5337.03, Los Angeles County, California",1058,55,239,92,819,99
6037533801,"Census Tract 5338.01, Los Angeles County, California",2012,96,646,123,1366,130
6037533803,"Census Tract 5338.03, Los Angeles County, California",1609,96,513,109,1096,133
6037533804,"Census Tract 5338.04, Los Angeles County, California",1209,72,422,99,787,128
6037533901,"Census Tract 5339.01, Los Angeles County, California",1426,82,228,79,1198,100
6037533902,"Census Tract 5339.02, Los Angeles County, California",971,47,338,96,633,98
6037534001,"Census Tract 5340.01, Los Angeles County, California",1280,59,384,89,896,113
6037534002,"Census Tract 5340.02, Los Angeles County, California",959,64,346,75,613,88
6037534101,"Census Tract 5341.01, Los Angeles County, California",558,24,216,71,342,70
6037534102,"Census Tract 5341.02, Los Angeles County, California",1495,74,308,119,1187,128
6037534201,"Census Tract 5342.01, Los Angeles County, California",1066,38,215,83,851,85
6037534202,"Census Tract 5342.02, Los Angeles County, California",1268,55,193,86,1075,98
6037534203,"Census Tract 5342.03, Los Angeles County, California",875,31,232,78,643,78
6037534301,"Census Tract 5343.01, Los Angeles County, California",1105,71,237,71,868,95
6037534302,"Census Tract 5343.02, Los Angeles County, California",835,47,128,61,707,78
6037534403,"Census Tract 5344.03, Los Angeles County, California",711,43,194,70,517,77
6037534404,"Census Tract 5344.04, Los Angeles County, California",955,63,209,82,746,100
6037534405,"Census Tract 5344.05, Los Angeles County, California",911,65,133,74,778,89
6037534406,"Census Tract 5344.06, Los Angeles County, California",913,78,128,48,785,92
6037534501,"Census Tract 5345.01, Los Angeles County, California",1278,74,690,93,588,101
6037534502,"Census Tract 5345.02, Los Angeles County, California",997,87,451,102,546,117
6037534700,"Census Tract 5347, Los Angeles County, California",914,69,678,78,236,112
6037534802,"Census Tract 5348.02, Los Angeles County, California",675,66,392,88,283,87
6037534803,"Census Tract 5348.03, Los Angeles County, California",1141,74,659,121,482,114
6037534804,"Census Tract 5348.04, Los Angeles County, California",887,53,384,83,503,96
6037534900,"Census Tract 5349, Los Angeles County, California",1566,60,555,102,1011,111
6037535000,"Census Tract 5350, Los Angeles County, California",1677,109,560,105,1117,135
6037535101,"Census Tract 5351.01, Los Angeles County, California",1632,78,637,102,995,124
6037535102,"Census Tract 5351.02, Los Angeles County, California",972,48,472,89,500,90
6037535200,"Census Tract 5352, Los Angeles County, California",1101,129,521,131,580,127
6037535300,"Census Tract 5353, Los Angeles County, California",1394,58,639,97,755,107
6037535400,"Census Tract 5354, Los Angeles County, California",644,68,393,86,251,92
6037535501,"Census Tract 5355.01, Los Angeles County, California",1001,70,127,66,874,91
6037535502,"Census Tract 5355.02, Los Angeles County, California",1230,65,396,124,834,140
6037535503,"Census Tract 5355.03, Los Angeles County, California",560,55,97,48,463,68
6037535603,"Census Tract 5356.03, Los Angeles County, California",940,73,339,84,601,107
6037535604,"Census Tract 5356.04, Los Angeles County, California",1026,56,453,84,573,88
6037535605,"Census Tract 5356.05, Los Angeles County, California",1106,69,372,104,734,128
6037535606,"Census Tract 5356.06, Los Angeles County, California",511,15,149,53,362,55
6037535607,"Census Tract 5356.07, Los Angeles County, California",1035,72,624,97,411,97
6037535701,"Census Tract 5357.01, Los Angeles County, California",1496,56,549,113,947,121
6037535702,"Census Tract 5357.02, Los Angeles County, California",1343,78,425,113,918,135
6037535802,"Census Tract 5358.02, Los Angeles County, California",1695,72,887,126,808,139
6037535803,"Census Tract 5358.03, Los Angeles County, California",1137,34,384,100,753,102
6037535804,"Census Tract 5358.04, Los Angeles County, California",1341,86,326,87,1015,126
6037535901,"Census Tract 5359.01, Los Angeles County, California",1425,53,880,106,545,116
6037535902,"Census Tract 5359.02, Los Angeles County, California",1571,38,1223,120,348,122
6037536000,"Census Tract 5360, Los Angeles County, California",1079,58,295,96,784,108
6037536101,"Census Tract 5361.01, Los Angeles County, California",2361,124,1234,178,1127,195
6037536102,"Census Tract 5361.02, Los Angeles County, California",1014,68,741,93,273,90
6037536200,"Census Tract 5362, Los Angeles County, California",1878,61,1209,155,669,156
6037540000,"Census Tract 5400, Los Angeles County, California",1459,93,576,117,883,125
6037540101,"Census Tract 5401.01, Los Angeles County, California",1301,82,849,92,452,86
6037540102,"Census Tract 5401.02, Los Angeles County, California",1397,103,1126,121,271,93
6037540201,"Census Tract 5402.01, Los Angeles County, California",571,36,93,43,478,57
6037540202,"Census Tract 5402.02, Los Angeles County, California",1508,80,338,97,1170,119
6037540203,"Census Tract 5402.03, Los Angeles County, California",1166,80,285,85,881,105
6037540300,"Census Tract 5403, Los Angeles County, California",1193,55,735,111,458,107
6037540400,"Census Tract 5404, Los Angeles County, California",475,52,256,61,219,58
6037540501,"Census Tract 5405.01, Los Angeles County, California",1067,52,609,100,458,94
6037540502,"Census Tract 5405.02, Los Angeles County, California",1372,84,417,95,955,124
6037540600,"Census Tract 5406, Los Angeles County, California",964,94,294,81,670,121
6037540700,"Census Tract 5407, Los Angeles County, California",764,53,408,79,356,78
6037540800,"Census Tract 5408, Los Angeles County, California",1642,129,803,139,839,180
6037540901,"Census Tract 5409.01, Los Angeles County, California",1139,56,701,118,438,115
6037540902,"Census Tract 5409.02, Los Angeles County, California",1312,127,809,121,503,149
6037541001,"Census Tract 5410.01, Los Angeles County, California",329,33,301,33,28,32
6037541002,"Census Tract 5410.02, Los Angeles County, California",977,101,908,120,69,69
6037541100,"Census Tract 5411, Los Angeles County, California",900,49,560,119,340,115
6037541200,"Census Tract 5412, Los Angeles County, California",1724,85,1190,124,534,122
6037541300,"Census Tract 5413, Los Angeles County, California",1340,89,969,111,371,98
6037541400,"Census Tract 5414, Los Angeles County, California",1484,90,694,123,790,135
6037541500,"Census Tract 5415, Los Angeles County, California",1104,128,422,105,682,124
6037541603,"Census Tract 5416.03, Los Angeles County, California",608,59,246,57,362,70
6037541604,"Census Tract 5416.04, Los Angeles County, California",1390,65,415,102,975,110
6037541605,"Census Tract 5416.05, Los Angeles County, California",1196,86,590,122,606,135
6037541606,"Census Tract 5416.06, Los Angeles County, California",561,56,99,71,462,90
6037541700,"Census Tract 5417, Los Angeles County, California",1297,82,943,129,354,116
6037541801,"Census Tract 5418.01, Los Angeles County, California",1056,100,428,127,628,114
6037541802,"Census Tract 5418.02, Los Angeles County, California",1026,92,732,120,294,105
6037542000,"Census Tract 5420, Los Angeles County, California",1101,72,684,119,417,123
6037542101,"Census Tract 5421.01, Los Angeles County, California",1483,90,797,115,686,116
6037542102,"Census Tract 5421.02, Los Angeles County, California",1616,73,858,116,758,128
6037542200,"Census Tract 5422, Los Angeles County, California",1532,58,1014,111,518,106
6037542401,"Census Tract 5424.01, Los Angeles County, California",1158,82,663,120,495,109
6037542402,"Census Tract 5424.02, Los Angeles County, California",698,80,505,79,193,76
6037542501,"Census Tract 5425.01, Los Angeles County, California",1118,51,627,102,491,102
6037542502,"Census Tract 5425.02, Los Angeles County, California",1273,92,379,98,894,104
6037542601,"Census Tract 5426.01, Los Angeles County, California",587,78,184,80,403,102
6037542602,"Census Tract 5426.02, Los Angeles County, California",1293,84,614,96,679,107
6037542700,"Census Tract 5427, Los Angeles County, California",1269,86,799,123,470,132
6037542800,"Census Tract 5428, Los Angeles County, California",909,46,756,94,153,86
6037542900,"Census Tract 5429, Los Angeles County, California",749,32,497,77,252,73
6037543000,"Census Tract 5430, Los Angeles County, California",1128,107,953,134,175,124
6037543100,"Census Tract 5431, Los Angeles County, California",1720,83,1385,138,335,96
6037543201,"Census Tract 5432.01, Los Angeles County, California",893,46,614,81,279,78
6037543202,"Census Tract 5432.02, Los Angeles County, California",1080,84,334,98,746,118
6037543303,"Census Tract 5433.03, Los Angeles County, California",1968,131,1343,156,625,177
6037543304,"Census Tract 5433.04, Los Angeles County, California",1887,84,1707,103,180,79
6037543305,"Census Tract 5433.05, Los Angeles County, California",942,46,901,67,41,46
6037543321,"Census Tract 5433.21, Los Angeles County, California",1601,109,1494,113,107,72
6037543322,"Census Tract 5433.22, Los Angeles County, California",2057,89,1901,137,156,102
6037543400,"Census Tract 5434, Los Angeles County, California",986,32,811,89,175,84
6037543501,"Census Tract 5435.01, Los Angeles County, California",2026,67,986,166,1040,170
6037543502,"Census Tract 5435.02, Los Angeles County, California",1255,99,883,110,372,106
6037543503,"Census Tract 5435.03, Los Angeles County, California",1743,110,1236,127,507,129
6037543601,"Census Tract 5436.01, Los Angeles County, California",1031,48,871,65,160,52
6037543602,"Census Tract 5436.02, Los Angeles County, California",2371,135,1570,188,801,200
6037543603,"Census Tract 5436.03, Los Angeles County, California",1568,64,1471,92,97,52
6037543604,"Census Tract 5436.04, Los Angeles County, California",1396,49,1239,102,157,88
6037543701,"Census Tract 5437.01, Los Angeles County, California",662,27,584,57,78,52
6037543702,"Census Tract 5437.02, Los Angeles County, California",1846,91,1526,129,320,94
6037543703,"Census Tract 5437.03, Los Angeles County, California",855,159,708,157,147,93
6037543801,"Census Tract 5438.01, Los Angeles County, California",1426,71,1192,106,234,85
6037543802,"Census Tract 5438.02, Los Angeles County, California",1824,137,931,224,893,183
6037543903,"Census Tract 5439.03, Los Angeles County, California",927,61,800,99,127,67
6037543904,"Census Tract 5439.04, Los Angeles County, California",968,50,577,124,391,125
6037544000,"Census Tract 5440, Los Angeles County, California",2109,68,1465,149,644,142
6037550000,"Census Tract 5500, Los Angeles County, California",141,66,121,57,20,32
6037550100,"Census Tract 5501, Los Angeles County, California",1788,73,1464,114,324,103
6037550200,"Census Tract 5502, Los Angeles County, California",2179,88,1548,162,631,166
6037550300,"Census Tract 5503, Los Angeles County, California",1949,108,1516,154,433,132
6037550400,"Census Tract 5504, Los Angeles County, California",385,26,317,63,68,54
6037550500,"Census Tract 5505, Los Angeles County, California",2281,88,1588,179,693,150
6037550600,"Census Tract 5506, Los Angeles County, California",2846,91,1913,157,933,159
6037550700,"Census Tract 5507, Los Angeles County, California",1935,91,1597,148,338,141
6037550800,"Census Tract 5508, Los Angeles County, California",2154,85,1313,182,841,183
6037550900,"Census Tract 5509, Los Angeles County, California",3081,127,599,106,2482,161
6037551000,"Census Tract 5510, Los Angeles County, California",2117,137,1446,144,671,167
6037551100,"Census Tract 5511, Los Angeles County, California",2694,114,538,137,2156,169
6037551201,"Census Tract 5512.01, Los Angeles County, California",1055,57,528,82,527,80
6037551202,"Census Tract 5512.02, Los Angeles County, California",1954,104,899,168,1055,170
6037551300,"Census Tract 5513, Los Angeles County, California",1725,80,511,114,1214,123
6037551400,"Census Tract 5514, Los Angeles County, California",2521,128,1366,173,1155,166
6037551500,"Census Tract 5515, Los Angeles County, California",2581,123,1323,170,1258,185
6037551600,"Census Tract 5516, Los Angeles County, California",0,132,0,132,0,132
6037551700,"Census Tract 5517, Los Angeles County, California",1674,59,1023,141,651,138
6037551800,"Census Tract 5518, Los Angeles County, California",2104,121,1282,112,822,114
6037551900,"Census Tract 5519, Los Angeles County, California",1421,57,971,112,450,104
6037552000,"Census Tract 5520, Los Angeles County, California",1910,74,1161,122,749,124
6037552100,"Census Tract 5521, Los Angeles County, California",1767,77,1087,98,680,93
6037552200,"Census Tract 5522, Los Angeles County, California",1786,72,461,103,1325,110
6037552300,"Census Tract 5523, Los Angeles County, California",2411,105,1445,169,966,177
6037552400,"Census Tract 5524, Los Angeles County, California",539,53,399,79,140,71
6037552601,"Census Tract 5526.01, Los Angeles County, California",1096,54,792,128,304,108
6037552602,"Census Tract 5526.02, Los Angeles County, California",1102,35,620,123,482,123
6037552700,"Census Tract 5527, Los Angeles County, California",1701,43,1320,135,381,125
6037552800,"Census Tract 5528, Los Angeles County, California",1587,72,999,127,588,124
6037552900,"Census Tract 5529, Los Angeles County, California",1814,99,1028,137,786,125
6037553000,"Census Tract 5530, Los Angeles County, California",1204,33,990,104,214,99
6037553100,"Census Tract 5531, Los Angeles County, California",1840,100,717,117,1123,130
6037553200,"Census Tract 5532, Los Angeles County, California",1900,72,1359,139,541,129
6037553300,"Census Tract 5533, Los Angeles County, California",974,58,789,93,185,82
6037553400,"Census Tract 5534, Los Angeles County, California",988,40,636,106,352,107
6037553501,"Census Tract 5535.01, Los Angeles County, California",2156,114,1152,199,1004,201
6037553502,"Census Tract 5535.02, Los Angeles County, California",1378,102,464,100,914,133
6037553601,"Census Tract 5536.01, Los Angeles County, California",1261,110,508,134,753,144
6037553602,"Census Tract 5536.02, Los Angeles County, California",1154,122,490,112,664,123
6037553701,"Census Tract 5537.01, Los Angeles County, California",959,45,414,75,545,85
6037553702,"Census Tract 5537.02, Los Angeles County, California",1136,70,668,100,468,94
6037553801,"Census Tract 5538.01, Los Angeles County, California",1101,70,297,101,804,122
6037553802,"Census Tract 5538.02, Los Angeles County, California",1973,101,1000,126,973,139
6037553901,"Census Tract 5539.01, Los Angeles County, California",1699,95,957,147,742,150
6037553902,"Census Tract 5539.02, Los Angeles County, California",1699,96,665,125,1034,146
6037554001,"Census Tract 5540.01, Los Angeles County, California",1172,61,797,102,375,101
6037554002,"Census Tract 5540.02, Los Angeles County, California",1645,73,551,104,1094,117
6037554101,"Census Tract 5541.01, Los Angeles County, California",1064,77,338,83,726,110
6037554102,"Census Tract 5541.02, Los Angeles County, California",2790,87,536,126,2254,128
6037554201,"Census Tract 5542.01, Los Angeles County, California",1122,41,745,102,377,100
6037554202,"Census Tract 5542.02, Los Angeles County, California",2488,166,590,127,1898,204
6037554300,"Census Tract 5543, Los Angeles County, California",2077,103,735,155,1342,165
6037554401,"Census Tract 5544.01, Los Angeles County, California",2683,102,976,135,1707,138
6037554403,"Census Tract 5544.03, Los Angeles County, California",1666,98,500,95,1166,112
6037554404,"Census Tract 5544.04, Los Angeles County, California",1312,79,191,70,1121,108
6037554511,"Census Tract 5545.11, Los Angeles County, California",1205,30,1043,82,162,79
6037554512,"Census Tract 5545.12, Los Angeles County, California",1843,46,1734,87,109,62
6037554513,"Census Tract 5545.13, Los Angeles County, California",817,24,646,78,171,79
6037554514,"Census Tract 5545.14, Los Angeles County, California",1399,73,1004,115,395,98
6037554515,"Census Tract 5545.15, Los Angeles County, California",1118,42,878,94,240,89
6037554516,"Census Tract 5545.16, Los Angeles County, California",1260,52,1061,90,199,80
6037554517,"Census Tract 5545.17, Los Angeles County, California",1480,36,1040,92,440,92
6037554518,"Census Tract 5545.18, Los Angeles County, California",1546,60,1321,101,225,88
6037554519,"Census Tract 5545.19, Los Angeles County, California",1143,58,1078,70,65,43
6037554521,"Census Tract 5545.21, Los Angeles County, California",2113,76,1603,166,510,152
6037554522,"Census Tract 5545.22, Los Angeles County, California",1516,54,1319,109,197,97
6037554600,"Census Tract 5546, Los Angeles County, California",1126,84,760,87,366,100
6037554700,"Census Tract 5547, Los Angeles County, California",918,70,771,93,147,68
6037554801,"Census Tract 5548.01, Los Angeles County, California",749,67,555,89,194,77
6037554802,"Census Tract 5548.02, Los Angeles County, California",1677,124,950,132,727,112
6037554900,"Census Tract 5549, Los Angeles County, California",1959,152,1042,201,917,204
6037555001,"Census Tract 5550.01, Los Angeles County, California",1373,81,845,100,528,101
6037555002,"Census Tract 5550.02, Los Angeles County, California",1023,56,563,80,460,99
6037555102,"Census Tract 5551.02, Los Angeles County, California",1991,107,895,132,1096,151
6037555103,"Census Tract 5551.03, Los Angeles County, California",1310,73,674,92,636,96
6037555104,"Census Tract 5551.04, Los Angeles County, California",1331,53,725,116,606,113
6037555202,"Census Tract 5552.02, Los Angeles County, California",1157,22,1065,58,92,54
6037555211,"Census Tract 5552.11, Los Angeles County, California",1487,130,804,147,683,150
6037555212,"Census Tract 5552.12, Los Angeles County, California",1326,119,678,133,648,132
6037570001,"Census Tract 5700.01, Los Angeles County, California",1336,58,863,103,473,98
6037570002,"Census Tract 5700.02, Los Angeles County, California",776,59,649,70,127,62
6037570003,"Census Tract 5700.03, Los Angeles County, California",1313,36,1174,82,139,75
6037570100,"Census Tract 5701, Los Angeles County, California",757,29,553,88,204,89
6037570202,"Census Tract 5702.02, Los Angeles County, California",1632,67,1167,129,465,118
6037570203,"Census Tract 5702.03, Los Angeles County, California",1257,62,258,64,999,87
6037570204,"Census Tract 5702.04, Los Angeles County, California",982,77,436,90,546,73
6037570301,"Census Tract 5703.01, Los Angeles County, California",2081,113,957,168,1124,201
6037570303,"Census Tract 5703.03, Los Angeles County, California",1269,71,585,119,684,137
6037570304,"Census Tract 5703.04, Los Angeles County, California",1422,78,386,89,1036,111
6037570401,"Census Tract 5704.01, Los Angeles County, California",1966,99,871,150,1095,158
6037570402,"Census Tract 5704.02, Los Angeles County, California",911,72,692,118,219,110
6037570501,"Census Tract 5705.01, Los Angeles County, California",2154,63,1298,176,856,175
6037570502,"Census Tract 5705.02, Los Angeles County, California",1680,106,1048,118,632,115
6037570601,"Census Tract 5706.01, Los Angeles County, California",1645,70,766,131,879,134
6037570602,"Census Tract 5706.02, Los Angeles County, California",1794,71,729,108,1065,117
6037570603,"Census Tract 5706.03, Los Angeles County, California",1606,102,264,74,1342,109
6037570701,"Census Tract 5707.01, Los Angeles County, California",2405,87,1405,171,1000,166
6037570702,"Census Tract 5707.02, Los Angeles County, California",778,18,644,78,134,78
6037570800,"Census Tract 5708, Los Angeles County, California",1720,56,1354,108,366,111
6037570901,"Census Tract 5709.01, Los Angeles County, California",1728,65,1460,98,268,99
6037570902,"Census Tract 5709.02, Los Angeles County, California",1202,28,983,87,219,84
6037571000,"Census Tract 5710, Los Angeles County, California",1829,78,1641,105,188,73
6037571101,"Census Tract 5711.01, Los Angeles County, California",1473,35,1308,92,165,83
6037571102,"Census Tract 5711.02, Los Angeles County, California",1271,27,1066,85,205,82
6037571200,"Census Tract 5712, Los Angeles County, California",2794,167,1511,213,1283,203
6037571300,"Census Tract 5713, Los Angeles County, California",1423,59,1157,92,266,98
6037571400,"Census Tract 5714, Los Angeles County, California",1492,86,1167,78,325,94
6037571501,"Census Tract 5715.01, Los Angeles County, California",2878,168,1515,182,1363,183
6037571502,"Census Tract 5715.02, Los Angeles County, California",1777,83,1004,145,773,140
6037571600,"Census Tract 5716, Los Angeles County, California",756,44,42,61,714,75
6037571701,"Census Tract 5717.01, Los Angeles County, California",1739,93,777,105,962,130
6037571702,"Census Tract 5717.02, Los Angeles County, California",2309,98,968,179,1341,181
6037571800,"Census Tract 5718, Los Angeles County, California",1253,65,1006,92,247,84
6037571900,"Census Tract 5719, Los Angeles County, California",2356,74,1174,142,1182,151
6037572001,"Census Tract 5720.01, Los Angeles County, California",2095,94,1424,167,671,148
6037572002,"Census Tract 5720.02, Los Angeles County, California",1737,126,735,127,1002,129
6037572100,"Census Tract 5721, Los Angeles County, California",324,25,239,62,85,56
6037572201,"Census Tract 5722.01, Los Angeles County, California",2025,121,1278,174,747,189
6037572202,"Census Tract 5722.02, Los Angeles County, California",1069,77,783,80,286,76
6037572301,"Census Tract 5723.01, Los Angeles County, California",932,61,450,85,482,91
6037572302,"Census Tract 5723.02, Los Angeles County, California",816,54,341,83,475,83
6037572400,"Census Tract 5724, Los Angeles County, California",301,87,245,87,56,53
6037572500,"Census Tract 5725, Los Angeles County, California",1279,74,389,73,890,108
6037572600,"Census Tract 5726, Los Angeles County, California",1243,49,815,131,428,131
6037572700,"Census Tract 5727, Los Angeles County, California",1329,62,868,112,461,131
6037572800,"Census Tract 5728, Los Angeles County, California",349,36,0,132,349,36
6037572900,"Census Tract 5729, Los Angeles County, California",1344,54,436,95,908,110
6037573001,"Census Tract 5730.01, Los Angeles County, California",2012,162,351,112,1661,169
6037573002,"Census Tract 5730.02, Los Angeles County, California",1088,80,129,58,959,92
6037573100,"Census Tract 5731, Los Angeles County, California",2379,103,780,172,1599,193
6037573201,"Census Tract 5732.01, Los Angeles County, California",1310,84,230,88,1080,118
6037573202,"Census Tract 5732.02, Los Angeles County, California",1422,106,486,98,936,138
6037573300,"Census Tract 5733, Los Angeles County, California",978,75,205,97,773,114
6037573401,"Census Tract 5734.01, Los Angeles County, California",485,49,211,61,274,58
6037573402,"Census Tract 5734.02, Los Angeles County, California",2332,155,870,184,1462,168
6037573403,"Census Tract 5734.03, Los Angeles County, California",1328,103,990,121,338,110
6037573500,"Census Tract 5735, Los Angeles County, California",0,132,0,132,0,132
6037573600,"Census Tract 5736, Los Angeles County, California",2150,139,1894,142,256,121
6037573700,"Census Tract 5737, Los Angeles County, California",1668,67,1479,102,189,90
6037573800,"Census Tract 5738, Los Angeles County, California",1561,35,1354,92,207,80
6037573901,"Census Tract 5739.01, Los Angeles County, California",0,132,0,132,0,132
6037573902,"Census Tract 5739.02, Los Angeles County, California",874,57,754,68,120,56
6037574000,"Census Tract 5740, Los Angeles County, California",1939,61,1740,90,199,82
6037574100,"Census Tract 5741, Los Angeles County, California",1880,96,1692,123,188,92
6037574201,"Census Tract 5742.01, Los Angeles County, California",1084,63,999,78,85,54
6037574202,"Census Tract 5742.02, Los Angeles County, California",738,42,281,68,457,69
6037574300,"Census Tract 5743, Los Angeles County, California",2137,108,1836,139,301,101
6037574400,"Census Tract 5744, Los Angeles County, California",1888,73,1631,111,257,95
6037574500,"Census Tract 5745, Los Angeles County, California",2342,54,2130,133,212,113
6037574601,"Census Tract 5746.01, Los Angeles County, California",0,132,0,132,0,132
6037574602,"Census Tract 5746.02, Los Angeles County, California",559,15,495,38,64,35
6037574700,"Census Tract 5747, Los Angeles County, California",0,132,0,132,0,132
6037574800,"Census Tract 5748, Los Angeles County, California",1355,91,793,85,562,113
6037574901,"Census Tract 5749.01, Los Angeles County, California",1407,33,1062,86,345,81
6037574902,"Census Tract 5749.02, Los Angeles County, California",1748,93,507,78,1241,119
6037575001,"Census Tract 5750.01, Los Angeles County, California",1552,102,577,105,975,128
6037575002,"Census Tract 5750.02, Los Angeles County, California",1843,86,664,81,1179,119
6037575101,"Census Tract 5751.01, Los Angeles County, California",1452,92,396,98,1056,122
6037575102,"Census Tract 5751.02, Los Angeles County, California",1251,64,243,89,1008,95
6037575103,"Census Tract 5751.03, Los Angeles County, California",1886,110,326,110,1560,150
6037575201,"Census Tract 5752.01, Los Angeles County, California",1388,103,254,83,1134,140
6037575202,"Census Tract 5752.02, Los Angeles County, California",1188,70,283,100,905,108
6037575300,"Census Tract 5753, Los Angeles County, California",1315,69,206,64,1109,91
6037575401,"Census Tract 5754.01, Los Angeles County, California",1178,98,53,35,1125,101
6037575402,"Census Tract 5754.02, Los Angeles County, California",1005,64,128,72,877,98
6037575500,"Census Tract 5755, Los Angeles County, California",20,22,0,132,20,22
6037575600,"Census Tract 5756, Los Angeles County, California",0,132,0,132,0,132
6037575801,"Census Tract 5758.01, Los Angeles County, California",653,69,133,58,520,89
6037575802,"Census Tract 5758.02, Los Angeles County, California",1529,128,341,108,1188,161
6037575803,"Census Tract 5758.03, Los Angeles County, California",967,116,97,49,870,131
6037575901,"Census Tract 5759.01, Los Angeles County, California",1134,149,375,101,759,155
6037575902,"Census Tract 5759.02, Los Angeles County, California",2416,185,447,129,1969,210
6037576000,"Census Tract 5760, Los Angeles County, California",585,86,47,36,538,86
6037576100,"Census Tract 5761, Los Angeles County, California",1980,159,922,144,1058,156
6037576200,"Census Tract 5762, Los Angeles County, California",2747,118,362,114,2385,152
6037576300,"Census Tract 5763, Los Angeles County, California",2820,144,365,121,2455,178
6037576401,"Census Tract 5764.01, Los Angeles County, California",1188,95,205,91,983,127
6037576402,"Census Tract 5764.02, Los Angeles County, California",1372,64,315,99,1057,96
6037576403,"Census Tract 5764.03, Los Angeles County, California",1371,110,277,70,1094,134
6037576501,"Census Tract 5765.01, Los Angeles County, California",1426,116,187,78,1239,130
6037576502,"Census Tract 5765.02, Los Angeles County, California",2108,101,482,113,1626,135
6037576503,"Census Tract 5765.03, Los Angeles County, California",1767,106,177,64,1590,125
6037576601,"Census Tract 5766.01, Los Angeles County, California",2689,207,658,125,2031,223
6037576602,"Census Tract 5766.02, Los Angeles County, California",2509,191,657,145,1852,244
6037576700,"Census Tract 5767, Los Angeles County, California",2191,128,889,150,1302,170
6037576801,"Census Tract 5768.01, Los Angeles County, California",1846,169,431,114,1415,191
6037576802,"Census Tract 5768.02, Los Angeles County, California",1900,100,354,105,1546,109
6037576901,"Census Tract 5769.01, Los Angeles County, California",1687,109,251,79,1436,127
6037576902,"Census Tract 5769.02, Los Angeles County, California",2571,129,420,118,2151,170
6037577000,"Census Tract 5770, Los Angeles County, California",2949,142,573,112,2376,152
6037577100,"Census Tract 5771, Los Angeles County, California",3126,156,1132,167,1994,223
6037577200,"Census Tract 5772, Los Angeles County, California",3191,190,610,119,2581,193
6037577300,"Census Tract 5773, Los Angeles County, California",3279,158,881,140,2398,195
6037577400,"Census Tract 5774, Los Angeles County, California",1601,105,596,120,1005,167
6037577501,"Census Tract 5775.01, Los Angeles County, California",1597,108,1127,104,470,120
6037577502,"Census Tract 5775.02, Los Angeles County, California",718,90,339,73,379,86
6037577601,"Census Tract 5776.01, Los Angeles County, California",702,59,658,59,44,30
6037577602,"Census Tract 5776.02, Los Angeles County, California",1710,94,1159,111,551,124
6037577603,"Census Tract 5776.03, Los Angeles County, California",3779,112,2626,210,1153,205
6037599000,"Census Tract 5990, Los Angeles County, California",1100,112,337,98,763,105
6037599100,"Census Tract 5991, Los Angeles County, California",175,53,10,15,165,56
6037600100,"Census Tract 6001, Los Angeles County, California",1919,107,400,97,1519,137
6037600201,"Census Tract 6002.01, Los Angeles County, California",1195,95,400,93,795,132
6037600202,"Census Tract 6002.02, Los Angeles County, California",1987,109,526,117,1461,156
6037600301,"Census Tract 6003.01, Los Angeles County, California",2070,138,338,111,1732,171
6037600302,"Census Tract 6003.02, Los Angeles County, California",1066,55,565,110,501,111
6037600400,"Census Tract 6004, Los Angeles County, California",1496,56,813,99,683,108
6037600501,"Census Tract 6005.01, Los Angeles County, California",900,75,513,90,387,90
6037600502,"Census Tract 6005.02, Los Angeles County, California",692,50,431,73,261,81
6037600601,"Census Tract 6006.01, Los Angeles County, California",936,102,680,99,256,84
6037600602,"Census Tract 6006.02, Los Angeles County, California",751,102,40,26,711,98
6037600702,"Census Tract 6007.02, Los Angeles County, California",1199,79,728,96,471,86
6037600703,"Census Tract 6007.03, Los Angeles County, California",908,72,908,72,0,132
6037600704,"Census Tract 6007.04, Los Angeles County, California",1149,86,640,91,509,99
6037600801,"Census Tract 6008.01, Los Angeles County, California",1236,85,942,122,294,110
6037600802,"Census Tract 6008.02, Los Angeles County, California",1163,91,517,93,646,127
6037600902,"Census Tract 6009.02, Los Angeles County, California",2641,108,377,127,2264,162
6037600911,"Census Tract 6009.11, Los Angeles County, California",1041,97,448,114,593,135
6037600912,"Census Tract 6009.12, Los Angeles County, California",1503,106,796,114,707,127
6037601001,"Census Tract 6010.01, Los Angeles County, California",1172,86,184,73,988,103
6037601002,"Census Tract 6010.02, Los Angeles County, California",2132,113,565,155,1567,192
6037601100,"Census Tract 6011, Los Angeles County, California",2048,107,181,87,1867,134
6037601202,"Census Tract 6012.02, Los Angeles County, California",1013,82,517,100,496,93
6037601211,"Census Tract 6012.11, Los Angeles County, California",1124,73,213,91,911,111
6037601212,"Census Tract 6012.12, Los Angeles County, California",2102,96,434,159,1668,160
6037601301,"Census Tract 6013.01, Los Angeles County, California",787,47,481,77,306,80
6037601302,"Census Tract 6013.02, Los Angeles County, California",3073,107,775,167,2298,176
6037601303,"Census Tract 6013.03, Los Angeles County, California",2104,117,219,82,1885,128
6037601401,"Census Tract 6014.01, Los Angeles County, California",1519,93,521,103,998,116
6037601402,"Census Tract 6014.02, Los Angeles County, California",1447,63,753,123,694,131
6037601501,"Census Tract 6015.01, Los Angeles County, California",978,82,194,72,784,94
6037601502,"Census Tract 6015.02, Los Angeles County, California",862,59,337,83,525,89
6037601600,"Census Tract 6016, Los Angeles County, California",1078,63,337,105,741,121
6037601700,"Census Tract 6017, Los Angeles County, California",1316,69,356,88,960,123
6037601801,"Census Tract 6018.01, Los Angeles County, California",817,54,167,48,650,66
6037601802,"Census Tract 6018.02, Los Angeles County, California",1000,43,343,79,657,92
6037601900,"Census Tract 6019, Los Angeles County, California",1370,124,332,91,1038,150
6037602002,"Census Tract 6020.02, Los Angeles County, California",815,76,440,91,375,109
6037602003,"Census Tract 6020.03, Los Angeles County, California",1278,70,444,106,834,120
6037602004,"Census Tract 6020.04, Los Angeles County, California",1020,77,584,105,436,95
6037602103,"Census Tract 6021.03, Los Angeles County, California",2024,122,264,100,1760,156
6037602104,"Census Tract 6021.04, Los Angeles County, California",1664,90,357,100,1307,115
6037602105,"Census Tract 6021.05, Los Angeles County, California",1212,100,255,81,957,100
6037602106,"Census Tract 6021.06, Los Angeles County, California",2047,121,457,113,1590,149
6037602200,"Census Tract 6022, Los Angeles County, California",1981,146,1251,175,730,160
6037602301,"Census Tract 6023.01, Los Angeles County, California",1933,70,1482,134,451,123
6037602302,"Census Tract 6023.02, Los Angeles County, California",1121,68,1015,85,106,50
6037602402,"Census Tract 6024.02, Los Angeles County, California",2147,108,899,158,1248,169
6037602403,"Census Tract 6024.03, Los Angeles County, California",1729,63,444,113,1285,130
6037602404,"Census Tract 6024.04, Los Angeles County, California",1942,93,283,96,1659,107
6037602501,"Census Tract 6025.01, Los Angeles County, California",3473,137,589,166,2884,216
6037602502,"Census Tract 6025.02, Los Angeles County, California",3351,153,190,92,3161,166
6037602503,"Census Tract 6025.03, Los Angeles County, California",3147,158,412,101,2735,176
6037602600,"Census Tract 6026, Los Angeles County, California",2726,152,1702,196,1024,213
6037602700,"Census Tract 6027, Los Angeles County, California",1080,45,952,62,128,53
6037602800,"Census Tract 6028, Los Angeles County, California",2182,157,1084,172,1098,197
6037602900,"Census Tract 6029, Los Angeles County, California",1274,87,663,98,611,120
6037603001,"Census Tract 6030.01, Los Angeles County, California",2326,120,871,144,1455,168
6037603003,"Census Tract 6030.03, Los Angeles County, California",2742,134,748,156,1994,209
6037603004,"Census Tract 6030.04, Los Angeles County, California",673,36,142,48,531,54
6037603101,"Census Tract 6031.01, Los Angeles County, California",1479,96,530,92,949,131
6037603102,"Census Tract 6031.02, Los Angeles County, California",1444,61,405,105,1039,120
6037603200,"Census Tract 6032, Los Angeles County, California",1104,52,817,85,287,77
6037603301,"Census Tract 6033.01, Los Angeles County, California",1635,85,408,90,1227,127
6037603302,"Census Tract 6033.02, Los Angeles County, California",1452,79,660,85,792,95
6037603400,"Census Tract 6034, Los Angeles County, California",1390,103,829,126,561,139
6037603500,"Census Tract 6035, Los Angeles County, California",864,96,727,114,137,79
6037603600,"Census Tract 6036, Los Angeles County, California",1350,72,1088,96,262,78
6037603702,"Census Tract 6037.02, Los Angeles County, California",1609,55,1357,113,252,94
6037603703,"Census Tract 6037.03, Los Angeles County, California",772,58,697,60,75,46
6037603704,"Census Tract 6037.04, Los Angeles County, California",2074,108,406,139,1668,172
6037603800,"Census Tract 6038, Los Angeles County, California",2440,128,564,150,1876,191
6037603900,"Census Tract 6039, Los Angeles County, California",2384,112,1006,172,1378,187
6037604000,"Census Tract 6040, Los Angeles County, California",2811,153,780,169,2031,198
6037604100,"Census Tract 6041, Los Angeles County, California",1785,114,697,132,1088,140
6037609900,"Census Tract 6099, Los Angeles County, California",663,15,359,76,304,76
6037620001,"Census Tract 6200.01, Los Angeles County, California",1581,74,812,109,769,118
6037620002,"Census Tract 6200.02, Los Angeles County, California",1501,86,457,76,1044,103
6037620003,"Census Tract 6200.03, Los Angeles County, California",0,132,0,132,0,132
6037620101,"Census Tract 6201.01, Los Angeles County, California",2296,94,1342,157,954,139
6037620102,"Census Tract 6201.02, Los Angeles County, California",1727,90,458,98,1269,125
6037620201,"Census Tract 6202.01, Los Angeles County, California",855,101,260,78,595,105
6037620301,"Census Tract 6203.01, Los Angeles County, California",1596,79,1278,85,318,81
6037620302,"Census Tract 6203.02, Los Angeles County, California",2700,207,1606,173,1094,166
6037620303,"Census Tract 6203.03, Los Angeles County, California",1715,60,1410,95,305,83
6037620400,"Census Tract 6204, Los Angeles County, California",1959,122,1379,136,580,152
6037620501,"Census Tract 6205.01, Los Angeles County, California",2002,119,1293,150,709,132
6037620521,"Census Tract 6205.21, Los Angeles County, California",1695,68,823,123,872,119
6037620522,"Census Tract 6205.22, Los Angeles County, California",1796,110,970,160,826,165
6037620601,"Census Tract 6206.01, Los Angeles County, California",2076,134,879,140,1197,164
6037620602,"Census Tract 6206.02, Los Angeles County, California",2090,79,1384,173,706,177
6037620701,"Census Tract 6207.01, Los Angeles County, California",2715,155,1256,157,1459,140
6037620702,"Census Tract 6207.02, Los Angeles County, California",2529,99,1966,141,563,131
6037620800,"Census Tract 6208, Los Angeles County, California",2738,103,2111,209,627,199
6037620901,"Census Tract 6209.01, Los Angeles County, California",1012,45,848,63,164,68
6037620902,"Census Tract 6209.02, Los Angeles County, California",1306,112,758,117,548,115
6037621001,"Census Tract 6210.01, Los Angeles County, California",1915,100,1162,147,753,133
6037621002,"Census Tract 6210.02, Los Angeles County, California",2732,144,1223,158,1509,195
6037621101,"Census Tract 6211.01, Los Angeles County, California",3432,194,1078,188,2354,259
6037621102,"Census Tract 6211.02, Los Angeles County, California",1147,94,773,87,374,87
6037621201,"Census Tract 6212.01, Los Angeles County, California",2581,120,1445,161,1136,185
6037621202,"Census Tract 6212.02, Los Angeles County, California",2168,228,835,188,1333,214
6037621301,"Census Tract 6213.01, Los Angeles County, California",3019,115,1774,164,1245,180
6037621321,"Census Tract 6213.21, Los Angeles County, California",2125,115,692,109,1433,145
6037621322,"Census Tract 6213.22, Los Angeles County, California",1662,128,352,71,1310,132
6037621400,"Census Tract 6214, Los Angeles County, California",1900,75,955,118,945,119
6037650001,"Census Tract 6500.01, Los Angeles County, California",2110,122,1462,157,648,156
6037650002,"Census Tract 6500.02, Los Angeles County, California",2672,124,943,172,1729,192
6037650101,"Census Tract 6501.01, Los Angeles County, California",2044,93,1772,132,272,107
6037650102,"Census Tract 6501.02, Los Angeles County, California",747,42,515,71,232,71
6037650200,"Census Tract 6502, Los Angeles County, California",1956,37,1464,115,492,120
6037650300,"Census Tract 6503, Los Angeles County, California",2476,111,1180,178,1296,178
6037650400,"Census Tract 6504, Los Angeles County, California",1421,72,1175,114,246,103
6037650501,"Census Tract 6505.01, Los Angeles County, California",1074,27,937,83,137,80
6037650502,"Census Tract 6505.02, Los Angeles County, California",1545,70,1073,107,472,111
6037650601,"Census Tract 6506.01, Los Angeles County, California",3429,144,445,108,2984,180
6037650602,"Census Tract 6506.02, Los Angeles County, California",2673,200,338,87,2335,194
6037650603,"Census Tract 6506.03, Los Angeles County, California",1523,62,1008,110,515,112
6037650701,"Census Tract 6507.01, Los Angeles County, California",854,54,728,68,126,55
6037650702,"Census Tract 6507.02, Los Angeles County, California",1538,60,1329,90,209,73
6037650800,"Census Tract 6508, Los Angeles County, California",2903,50,2084,178,819,173
6037650901,"Census Tract 6509.01, Los Angeles County, California",2407,132,1072,175,1335,202
6037650902,"Census Tract 6509.02, Los Angeles County, California",2237,123,1065,149,1172,168
6037651001,"Census Tract 6510.01, Los Angeles County, California",1961,80,1628,128,333,105
6037651002,"Census Tract 6510.02, Los Angeles County, California",1650,94,1024,119,626,109
6037651101,"Census Tract 6511.01, Los Angeles County, California",1811,70,1036,101,775,112
6037651102,"Census Tract 6511.02, Los Angeles County, California",1712,75,663,108,1049,114
6037651201,"Census Tract 6512.01, Los Angeles County, California",1737,54,1415,103,322,109
6037651221,"Census Tract 6512.21, Los Angeles County, California",1290,73,472,87,818,88
6037651222,"Census Tract 6512.22, Los Angeles County, California",2289,98,664,120,1625,147
6037651301,"Census Tract 6513.01, Los Angeles County, California",2447,138,1257,143,1190,173
6037651302,"Census Tract 6513.02, Los Angeles County, California",2408,114,1883,116,525,126
6037651400,"Census Tract 6514, Los Angeles County, California",3311,124,2031,189,1280,196
6037670001,"Census Tract 6700.01, Los Angeles County, California",1113,125,727,103,386,94
6037670002,"Census Tract 6700.02, Los Angeles County, California",1439,74,487,89,952,98
6037670003,"Census Tract 6700.03, Los Angeles County, California",2201,115,922,149,1279,172
6037670100,"Census Tract 6701, Los Angeles County, California",2631,127,1356,176,1275,187
6037670201,"Census Tract 6702.01, Los Angeles County, California",1496,66,1300,86,196,76
6037670202,"Census Tract 6702.02, Los Angeles County, California",912,75,912,75,0,132
6037670301,"Census Tract 6703.01, Los Angeles County, California",1965,129,1722,141,243,71
6037670321,"Census Tract 6703.21, Los Angeles County, California",1299,86,1260,89,39,43
6037670322,"Census Tract 6703.22, Los Angeles County, California",1552,96,1409,104,143,58
6037670403,"Census Tract 6704.03, Los Angeles County, California",829,23,761,44,68,38
6037670405,"Census Tract 6704.05, Los Angeles County, California",1050,63,801,75,249,70
6037670406,"Census Tract 6704.06, Los Angeles County, California",677,54,576,74,101,59
6037670407,"Census Tract 6704.07, Los Angeles County, California",2099,106,1117,165,982,170
6037670411,"Census Tract 6704.11, Los Angeles County, California",1431,67,1223,72,208,79
6037670413,"Census Tract 6704.13, Los Angeles County, California",1695,64,1339,98,356,90
6037670414,"Census Tract 6704.14, Los Angeles County, California",1328,94,927,95,401,92
6037670500,"Census Tract 6705, Los Angeles County, California",613,39,598,40,15,12
6037670600,"Census Tract 6706, Los Angeles County, California",2647,95,2170,153,477,142
6037670701,"Census Tract 6707.01, Los Angeles County, California",2377,102,1935,127,442,127
6037670702,"Census Tract 6707.02, Los Angeles County, California",1872,82,1847,83,25,28
6037700100,"Census Tract 7001, Los Angeles County, California",5895,230,398,137,5497,239
6037700200,"Census Tract 7002, Los Angeles County, California",4324,233,340,93,3984,246
6037700300,"Census Tract 7003, Los Angeles County, California",4028,166,1379,248,2649,246
6037700400,"Census Tract 7004, Los Angeles County, California",3262,215,617,174,2645,225
6037700500,"Census Tract 7005, Los Angeles County, California",5743,267,2372,284,3371,310
6037700600,"Census Tract 7006, Los Angeles County, California",1853,102,1750,120,103,55
6037700700,"Census Tract 7007, Los Angeles County, California",1113,72,1058,78,55,47
6037700800,"Census Tract 7008, Los Angeles County, California",4359,231,1482,236,2877,265
6037700901,"Census Tract 7009.01, Los Angeles County, California",1418,91,717,99,701,111
6037700902,"Census Tract 7009.02, Los Angeles County, California",3041,154,675,143,2366,196
6037701000,"Census Tract 7010, Los Angeles County, California",2632,177,834,131,1798,215
6037701100,"Census Tract 7011, Los Angeles County, California",11,16,0,132,11,16
6037701201,"Census Tract 7012.01, Los Angeles County, California",1525,91,1344,102,181,77
6037701202,"Census Tract 7012.02, Los Angeles County, California",1780,90,488,106,1292,127
6037701301,"Census Tract 7013.01, Los Angeles County, California",3237,159,1629,191,1608,219
6037701302,"Census Tract 7013.02, Los Angeles County, California",2807,139,523,147,2284,191
6037701400,"Census Tract 7014, Los Angeles County, California",4240,153,515,130,3725,209
6037701501,"Census Tract 7015.01, Los Angeles County, California",2734,139,662,156,2072,202
6037701502,"Census Tract 7015.02, Los Angeles County, California",1870,109,247,88,1623,135
6037701601,"Census Tract 7016.01, Los Angeles County, California",1769,71,956,100,813,114
6037701602,"Census Tract 7016.02, Los Angeles County, California",1841,91,527,131,1314,145
6037701701,"Census Tract 7017.01, Los Angeles County, California",1733,74,456,110,1277,128
6037701702,"Census Tract 7017.02, Los Angeles County, California",1413,117,109,62,1304,116
6037701801,"Census Tract 7018.01, Los Angeles County, California",2430,172,700,169,1730,202
6037701802,"Census Tract 7018.02, Los Angeles County, California",1819,96,239,89,1580,119
6037701900,"Census Tract 7019, Los Angeles County, California",2342,162,47,39,2295,165
6037702000,"Census Tract 7020, Los Angeles County, California",3275,173,744,170,2531,226
6037702100,"Census Tract 7021, Los Angeles County, California",3737,168,1021,163,2716,218
6037702201,"Census Tract 7022.01, Los Angeles County, California",2167,97,641,160,1526,178
6037702202,"Census Tract 7022.02, Los Angeles County, California",1715,60,965,123,750,128
6037702300,"Census Tract 7023, Los Angeles County, California",3007,117,1298,164,1709,192
6037702400,"Census Tract 7024, Los Angeles County, California",1913,106,683,119,1230,136
6037702501,"Census Tract 7025.01, Los Angeles County, California",2025,105,1082,151,943,169
6037702502,"Census Tract 7025.02, Los Angeles County, California",2053,96,1536,152,517,131
6037702600,"Census Tract 7026, Los Angeles County, California",2244,93,1762,133,482,125
6037702700,"Census Tract 7027, Los Angeles County, California",1230,68,1136,80,94,49
6037702801,"Census Tract 7028.01, Los Angeles County, California",1893,86,699,118,1194,141
6037702802,"Census Tract 7028.02, Los Angeles County, California",853,60,394,108,459,110
6037702803,"Census Tract 7028.03, Los Angeles County, California",1036,77,470,119,566,116
6037702901,"Census Tract 7029.01, Los Angeles County, California",5887,276,405,119,5482,311
6037703001,"Census Tract 7030.01, Los Angeles County, California",3031,158,1817,209,1214,204
6037703002,"Census Tract 7030.02, Los Angeles County, California",2857,74,2050,180,807,171
6037703100,"Census Tract 7031, Los Angeles County, California",2343,116,1664,157,679,163
6037703200,"Census Tract 7032, Los Angeles County, California",2146,152,1703,166,443,144
6037800101,"Census Tract 8001.01, Los Angeles County, California",1570,107,1484,109,86,47
6037800102,"Census Tract 8001.02, Los Angeles County, California",2733,111,2380,187,353,149
6037800201,"Census Tract 8002.01, Los Angeles County, California",3101,155,2804,189,297,117
6037800202,"Census Tract 8002.02, Los Angeles County, California",2001,128,1875,138,126,73
6037800302,"Census Tract 8003.02, Los Angeles County, California",3431,202,1853,190,1578,242
6037800303,"Census Tract 8003.03, Los Angeles County, California",2725,148,1807,192,918,179
6037800323,"Census Tract 8003.23, Los Angeles County, California",2760,127,2620,162,140,80
6037800324,"Census Tract 8003.24, Los Angeles County, California",2763,114,2464,172,299,143
6037800325,"Census Tract 8003.25, Los Angeles County, California",1389,121,1177,124,212,69
6037800326,"Census Tract 8003.26, Los Angeles County, California",2019,128,1659,169,360,123
6037800401,"Census Tract 8004.01, Los Angeles County, California",694,80,478,96,216,77
6037800403,"Census Tract 8004.03, Los Angeles County, California",2765,172,2224,205,541,169
6037800404,"Census Tract 8004.04, Los Angeles County, California",851,87,692,78,159,80
6037800501,"Census Tract 8005.01, Los Angeles County, California",1363,120,1010,116,353,114
6037800502,"Census Tract 8005.02, Los Angeles County, California",1194,131,723,129,471,116
6037900101,"Census Tract 9001.01, Los Angeles County, California",3153,183,2408,226,745,168
6037900102,"Census Tract 9001.02, Los Angeles County, California",288,69,199,66,89,67
6037900200,"Census Tract 9002, Los Angeles County, California",425,87,207,85,218,88
6037900300,"Census Tract 9003, Los Angeles County, California",854,104,731,115,123,74
6037900501,"Census Tract 9005.01, Los Angeles County, California",1727,127,1124,156,603,150
6037900502,"Census Tract 9005.02, Los Angeles County, California",2483,98,1597,160,886,154
6037900503,"Census Tract 9005.03, Los Angeles County, California",2742,122,1876,213,866,229
6037900504,"Census Tract 9005.04, Los Angeles County, California",1309,120,879,132,430,125
6037900602,"Census Tract 9006.02, Los Angeles County, California",1436,93,1068,140,368,113
6037900604,"Census Tract 9006.04, Los Angeles County, California",2641,149,1744,181,897,174
6037900605,"Census Tract 9006.05, Los Angeles County, California",1813,107,1454,141,359,125
6037900606,"Census Tract 9006.06, Los Angeles County, California",1070,96,584,102,486,109
6037900607,"Census Tract 9006.07, Los Angeles County, California",1122,76,535,102,587,112
6037900701,"Census Tract 9007.01, Los Angeles County, California",1608,109,892,141,716,143
6037900703,"Census Tract 9007.03, Los Angeles County, California",1670,126,452,95,1218,153
6037900704,"Census Tract 9007.04, Los Angeles County, California",1244,76,10,15,1234,77
6037900705,"Census Tract 9007.05, Los Angeles County, California",2243,131,712,136,1531,156
6037900803,"Census Tract 9008.03, Los Angeles County, California",2345,136,1763,182,582,155
6037900804,"Census Tract 9008.04, Los Angeles County, California",864,102,451,114,413,122
6037900805,"Census Tract 9008.05, Los Angeles County, California",1278,97,945,123,333,111
6037900806,"Census Tract 9008.06, Los Angeles County, California",1340,97,156,67,1184,108
6037900900,"Census Tract 9009, Los Angeles County, California",1136,96,1040,102,96,52
6037901003,"Census Tract 9010.03, Los Angeles County, California",0,132,0,132,0,132
6037901004,"Census Tract 9010.04, Los Angeles County, California",2475,159,1937,194,538,135
6037901005,"Census Tract 9010.05, Los Angeles County, California",2688,114,1734,161,954,168
6037901006,"Census Tract 9010.06, Los Angeles County, California",3636,145,2469,234,1167,218
6037901007,"Census Tract 9010.07, Los Angeles County, California",654,29,594,48,60,42
6037901101,"Census Tract 9011.01, Los Angeles County, California",1576,108,1144,122,432,104
6037901102,"Census Tract 9011.02, Los Angeles County, California",1597,132,1087,143,510,148
6037901203,"Census Tract 9012.03, Los Angeles County, California",595,90,507,104,88,54
6037901204,"Census Tract 9012.04, Los Angeles County, California",812,75,678,94,134,83
6037901205,"Census Tract 9012.05, Los Angeles County, California",2729,136,1986,162,743,138
6037901206,"Census Tract 9012.06, Los Angeles County, California",423,48,368,52,55,46
6037901207,"Census Tract 9012.07, Los Angeles County, California",1028,68,984,70,44,37
6037910000,"Census Tract 9100, Los Angeles County, California",3324,172,2743,235,581,185
6037910100,"Census Tract 9101, Los Angeles County, California",319,89,160,61,159,87
6037910201,"Census Tract 9102.01, Los Angeles County, California",1133,78,833,119,300,101
6037910202,"Census Tract 9102.02, Los Angeles County, California",1387,99,1308,118,79,54
6037910203,"Census Tract 9102.03, Los Angeles County, California",2916,218,2398,239,518,192
6037910204,"Census Tract 9102.04, Los Angeles County, California",3266,128,2965,176,301,121
6037910205,"Census Tract 9102.05, Los Angeles County, California",377,55,349,55,28,36
6037910206,"Census Tract 9102.06, Los Angeles County, California",706,109,565,119,141,84
6037910301,"Census Tract 9103.01, Los Angeles County, California",1369,99,1171,115,198,95
6037910302,"Census Tract 9103.02, Los Angeles County, California",1826,86,1694,105,132,76
6037910401,"Census Tract 9104.01, Los Angeles County, California",1710,111,1194,115,516,107
6037910402,"Census Tract 9104.02, Los Angeles County, California",810,98,309,68,501,101
6037910403,"Census Tract 9104.03, Los Angeles County, California",657,48,89,39,568,62
6037910404,"Census Tract 9104.04, Los Angeles County, California",1078,88,654,100,424,112
6037910501,"Census Tract 9105.01, Los Angeles County, California",1731,132,43,36,1688,129
6037910502,"Census Tract 9105.02, Los Angeles County, California",1059,72,490,102,569,96
6037910503,"Census Tract 9105.03, Los Angeles County, California",1877,97,1096,189,781,160
6037910601,"Census Tract 9106.01, Los Angeles County, California",1546,69,948,128,598,121
6037910602,"Census Tract 9106.02, Los Angeles County, California",1081,81,439,118,642,137
6037910603,"Census Tract 9106.03, Los Angeles County, California",1813,125,1315,148,498,121
6037910604,"Census Tract 9106.04, Los Angeles County, California",1771,151,1374,189,397,157
6037910703,"Census Tract 9107.03, Los Angeles County, California",2672,158,2033,231,639,217
6037910704,"Census Tract 9107.04, Los Angeles County, California",1988,119,1534,196,454,167
6037910705,"Census Tract 9107.05, Los Angeles County, California",1892,132,1530,150,362,149
6037910706,"Census Tract 9107.06, Los Angeles County, California",1127,90,927,120,200,115
6037910707,"Census Tract 9107.07, Los Angeles County, California",1388,95,849,101,539,93
6037910708,"Census Tract 9107.08, Los Angeles County, California",144,38,144,38,0,132
6037910709,"Census Tract 9107.09, Los Angeles County, California",434,59,369,76,65,64
6037910710,"Census Tract 9107.10, Los Angeles County, California",3228,130,2557,173,671,166
6037910803,"Census Tract 9108.03, Los Angeles County, California",1292,80,1223,100,69,41
6037910804,"Census Tract 9108.04, Los Angeles County, California",870,93,755,80,115,75
6037910805,"Census Tract 9108.05, Los Angeles County, California",1486,129,1309,133,177,99
6037910806,"Census Tract 9108.06, Los Angeles County, California",103,48,81,47,22,25
6037910807,"Census Tract 9108.07, Los Angeles County, California",1697,106,1412,133,285,118
6037910808,"Census Tract 9108.08, Los Angeles County, California",1172,36,1043,76,129,68
6037910809,"Census Tract 9108.09, Los Angeles County, California",570,67,531,62,39,33
6037910810,"Census Tract 9108.10, Los Angeles County, California",818,45,721,64,97,53
6037910901,"Census Tract 9109.01, Los Angeles County, California",583,58,547,56,36,25
6037910902,"Census Tract 9109.02, Los Angeles County, California",500,96,349,91,151,63
6037911000,"Census Tract 9110, Los Angeles County, California",508,104,395,103,113,79
6037920013,"Census Tract 9200.13, Los Angeles County, California",1167,54,1085,71,82,61
6037920014,"Census Tract 9200.14, Los Angeles County, California",71,39,62,36,9,15
6037920015,"Census Tract 9200.15, Los Angeles County, California",1512,61,1358,82,154,82
6037920016,"Census Tract 9200.16, Los Angeles County, California",1700,59,1620,65,80,47
6037920017,"Census Tract 9200.17, Los Angeles County, California",1377,46,1231,68,146,66
6037920018,"Census Tract 9200.18, Los Angeles County, California",762,16,652,60,110,60
6037920019,"Census Tract 9200.19, Los Angeles County, California",2249,76,2043,140,206,115
6037920020,"Census Tract 9200.20, Los Angeles County, California",2055,84,1814,123,241,113
6037920023,"Census Tract 9200.23, Los Angeles County, California",728,52,668,63,60,52
6037920026,"Census Tract 9200.26, Los Angeles County, California",88,50,69,48,19,15
6037920027,"Census Tract 9200.27, Los Angeles County, California",0,132,0,132,0,132
6037920028,"Census Tract 9200.28, Los Angeles County, California",1228,130,1127,126,101,78
6037920029,"Census Tract 9200.29, Los Angeles County, California",1236,37,1038,72,198,63
6037920030,"Census Tract 9200.30, Los Angeles County, California",1902,70,1361,105,541,93
6037920031,"Census Tract 9200.31, Los Angeles County, California",2436,74,2174,108,262,92
6037920032,"Census Tract 9200.32, Los Angeles County, California",713,70,669,45,44,61
6037920033,"Census Tract 9200.33, Los Angeles County, California",168,67,106,44,62,62
6037920034,"Census Tract 9200.34, Los Angeles County, California",994,81,741,92,253,93
6037920035,"Census Tract 9200.35, Los Angeles County, California",1997,146,1487,145,510,130
6037920036,"Census Tract 9200.36, Los Angeles County, California",921,61,536,106,385,120
6037920037,"Census Tract 9200.37, Los Angeles County, California",2140,135,223,77,1917,159
6037920038,"Census Tract 9200.38, Los Angeles County, California",1708,73,848,149,860,141
6037920039,"Census Tract 9200.39, Los Angeles County, California",568,15,545,33,23,28
6037920040,"Census Tract 9200.40, Los Angeles County, California",796,68,472,56,324,81
6037920041,"Census Tract 9200.41, Los Angeles County, California",881,94,362,79,519,103
6037920042,"Census Tract 9200.42, Los Angeles County, California",2742,110,1819,176,923,179
6037920043,"Census Tract 9200.43, Los Angeles County, California",1152,112,1072,111,80,60
6037920103,"Census Tract 9201.03, Los Angeles County, California",1375,101,813,140,562,131
6037920104,"Census Tract 9201.04, Los Angeles County, California",729,29,638,74,91,70
6037920105,"Census Tract 9201.05, Los Angeles County, California",3892,44,3645,157,247,149
6037920106,"Census Tract 9201.06, Los Angeles County, California",852,59,693,78,159,72
6037920107,"Census Tract 9201.07, Los Angeles County, California",1103,120,621,135,482,123
6037920108,"Census Tract 9201.08, Los Angeles County, California",842,100,558,104,284,80
6037920109,"Census Tract 9201.09, Los Angeles County, California",1101,103,683,85,418,108
6037920110,"Census Tract 9201.10, Los Angeles County, California",1667,37,1363,74,304,61
6037920111,"Census Tract 9201.11, Los Angeles County, California",1008,24,808,84,200,77
6037920112,"Census Tract 9201.12, Los Angeles County, California",1652,44,1177,92,475,85
6037920113,"Census Tract 9201.13, Los Angeles County, California",2719,145,1642,182,1077,205
6037920200,"Census Tract 9202, Los Angeles County, California",0,132,0,132,0,132
6037920303,"Census Tract 9203.03, Los Angeles County, California",456,56,186,69,270,68
6037920312,"Census Tract 9203.12, Los Angeles County, California",1898,100,971,100,927,98
6037920313,"Census Tract 9203.13, Los Angeles County, California",1719,73,1572,96,147,69
6037920314,"Census Tract 9203.14, Los Angeles County, California",890,50,731,78,159,77
6037920322,"Census Tract 9203.22, Los Angeles County, California",1056,49,763,80,293,75
6037920326,"Census Tract 9203.26, Los Angeles County, California",2027,95,1219,125,808,116
6037920327,"Census Tract 9203.27, Los Angeles County, California",3770,167,3448,207,322,136
6037920328,"Census Tract 9203.28, Los Angeles County, California",645,83,292,45,353,77
6037920329,"Census Tract 9203.29, Los Angeles County, California",2167,62,1369,168,798,170
6037920330,"Census Tract 9203.30, Los Angeles County, California",2158,109,1665,200,493,184
6037920331,"Census Tract 9203.31, Los Angeles County, California",1437,28,1156,73,281,70
6037920332,"Census Tract 9203.32, Los Angeles County, California",642,22,555,69,87,59
6037920334,"Census Tract 9203.34, Los Angeles County, California",2190,40,1706,108,484,109
6037920335,"Census Tract 9203.35, Los Angeles County, California",3223,139,837,138,2386,182
6037930000,"Census Tract 9300, Los Angeles County, California",185,45,138,53,47,37
6037930100,"Census Tract 9301, Los Angeles County, California",57,30,47,30,10,16
6037930200,"Census Tract 9302, Los Angeles County, California",308,45,270,58,38,48
6039000102,"Census Tract 1.02, Madera County, California",1984,186,1406,193,578,196
6039000103,"Census Tract 1.03, Madera County, California",2378,190,1628,215,750,248
6039000104,"Census Tract 1.04, Madera County, California",2003,177,1357,197,646,198
6039000105,"Census Tract 1.05, Madera County, California",5373,240,4337,288,1036,228
6039000200,"Census Tract 2, Madera County, California",1989,209,1083,170,906,153
6039000300,"Census Tract 3, Madera County, California",2474,403,1116,227,1358,308
6039000400,"Census Tract 4, Madera County, California",423,58,184,54,239,55
6039000502,"Census Tract 5.02, Madera County, California",2274,189,1152,176,1122,172
6039000503,"Census Tract 5.03, Madera County, California",2451,212,1595,221,856,185
6039000506,"Census Tract 5.06, Madera County, California",1789,139,1398,138,391,113
6039000507,"Census Tract 5.07, Madera County, California",2441,174,1854,215,587,160
6039000508,"Census Tract 5.08, Madera County, California",1926,148,1492,193,434,171
6039000509,"Census Tract 5.09, Madera County, California",2031,130,1852,143,179,127
6039000601,"Census Tract 6.01, Madera County, California",2358,160,919,187,1439,195
6039000602,"Census Tract 6.02, Madera County, California",1145,102,593,96,552,119
6039000700,"Census Tract 7, Madera County, California",3479,233,2567,233,912,187
6039000800,"Census Tract 8, Madera County, California",1845,143,431,111,1414,174
6039000900,"Census Tract 9, Madera County, California",1685,152,729,124,956,147
6039001000,"Census Tract 10, Madera County, California",1924,132,1189,131,735,140
6041101100,"Census Tract 1011, Marin County, California",1011,75,862,76,149,90
6041101200,"Census Tract 1012, Marin County, California",1016,74,825,103,191,87
6041102100,"Census Tract 1021, Marin County, California",909,59,748,90,161,67
6041102201,"Census Tract 1022.01, Marin County, California",3972,181,2378,179,1594,202
6041103100,"Census Tract 1031, Marin County, California",2645,107,2341,162,304,138
6041103200,"Census Tract 1032, Marin County, California",2554,111,1565,177,989,172
6041104101,"Census Tract 1041.01, Marin County, California",3041,152,2349,162,692,161
6041104102,"Census Tract 1041.02, Marin County, California",2059,111,1060,178,999,183
6041104200,"Census Tract 1042, Marin County, California",2434,120,1692,190,742,182
6041104300,"Census Tract 1043, Marin County, California",590,63,553,52,37,35
6041105000,"Census Tract 1050, Marin County, California",2388,143,1700,167,688,155
6041106001,"Census Tract 1060.01, Marin County, California",2021,143,974,115,1047,152
6041106002,"Census Tract 1060.02, Marin County, California",2166,131,1314,163,852,184
6041107000,"Census Tract 1070, Marin County, California",2452,96,2067,174,385,138
6041108100,"Census Tract 1081, Marin County, California",2610,155,2320,193,290,124
6041108200,"Census Tract 1082, Marin County, California",2858,172,1579,195,1279,234
6041109000,"Census Tract 1090, Marin County, California",3530,221,1866,209,1664,253
6041110100,"Census Tract 1101, Marin County, California",2336,163,1220,153,1116,153
6041110200,"Census Tract 1102, Marin County, California",2238,115,2118,131,120,65
6041111000,"Census Tract 1110, Marin County, California",2662,162,1025,153,1637,201
6041112100,"Census Tract 1121, Marin County, California",1846,112,869,135,977,147
6041112200,"Census Tract 1122, Marin County, California",3060,202,767,159,2293,210
6041113000,"Census Tract 1130, Marin County, California",1439,104,1055,142,384,143
6041114100,"Census Tract 1141, Marin County, California",2059,156,1462,176,597,126
6041114200,"Census Tract 1142, Marin County, California",1233,87,692,167,541,131
6041115000,"Census Tract 1150, Marin County, California",2746,118,2401,157,345,113
6041116000,"Census Tract 1160, Marin County, California",1245,84,844,107,401,96
6041117000,"Census Tract 1170, Marin County, California",1832,121,1122,127,710,128
6041118100,"Census Tract 1181, Marin County, California",697,52,608,59,89,35
6041118200,"Census Tract 1182, Marin County, California",109,42,41,23,68,35
6041119100,"Census Tract 1191, Marin County, California",1854,77,1291,101,563,102
6041119200,"Census Tract 1192, Marin County, California",3026,141,1720,196,1306,184
6041120000,"Census Tract 1200, Marin County, California",2730,164,1823,170,907,139
6041121100,"Census Tract 1211, Marin County, California",2447,127,1530,195,917,170
6041121200,"Census Tract 1212, Marin County, California",2621,101,1689,185,932,176
6041122000,"Census Tract 1220, Marin County, California",12,20,0,132,12,20
6041123000,"Census Tract 1230, Marin County, California",937,68,690,82,247,63
6041124100,"Census Tract 1241, Marin County, California",2239,126,1496,149,743,168
6041124200,"Census Tract 1242, Marin County, California",2380,156,1476,143,904,157
6041125000,"Census Tract 1250, Marin County, California",1832,135,796,110,1036,147
6041126100,"Census Tract 1261, Marin County, California",2165,147,1651,151,514,140
6041126200,"Census Tract 1262, Marin County, California",2038,131,1014,122,1024,142
6041127000,"Census Tract 1270, Marin County, California",1734,140,1195,155,539,130
6041128100,"Census Tract 1281, Marin County, California",2548,148,2003,210,545,188
6041128200,"Census Tract 1282, Marin County, California",1981,94,1710,124,271,95
6041129000,"Census Tract 1290, Marin County, California",1153,117,238,70,915,93
6041130200,"Census Tract 1302, Marin County, California",4688,247,2496,277,2192,296
6041131000,"Census Tract 1310, Marin County, California",243,48,118,31,125,38
6041132100,"Census Tract 1321, Marin County, California",781,94,549,89,232,76
6041132200,"Census Tract 1322, Marin County, California",770,122,497,124,273,91
6041133000,"Census Tract 1330, Marin County, California",1149,139,685,115,464,120
6043000100,"Census Tract 1, Mariposa County, California",2835,290,1908,258,927,282
6043000200,"Census Tract 2, Mariposa County, California",1444,183,1118,158,326,162
6043000300,"Census Tract 3, Mariposa County, California",2954,249,2065,192,889,232
6043000400,"Census Tract 4, Mariposa County, California",450,149,69,69,381,155
6045010100,"Census Tract 101, Mendocino County, California",1120,81,838,95,282,83
6045010200,"Census Tract 102, Mendocino County, California",1504,130,1085,144,419,117
6045010300,"Census Tract 103, Mendocino County, California",1689,121,1308,156,381,110
6045010400,"Census Tract 104, Mendocino County, California",1318,128,654,120,664,118
6045010500,"Census Tract 105, Mendocino County, California",1628,152,640,133,988,153
6045010600,"Census Tract 106, Mendocino County, California",2860,176,2370,197,490,141
6045010700,"Census Tract 107, Mendocino County, California",2452,191,1191,213,1261,224
6045010801,"Census Tract 108.01, Mendocino County, California",2114,140,1599,141,515,122
6045010802,"Census Tract 108.02, Mendocino County, California",688,79,462,75,226,72
6045010900,"Census Tract 109, Mendocino County, California",1686,129,1221,129,465,138
6045011000,"Census Tract 110, Mendocino County, California",3661,242,3055,262,606,186
6045011100,"Census Tract 111, Mendocino County, California",1652,191,1221,171,431,131
6045011200,"Census Tract 112, Mendocino County, California",1188,102,795,123,393,117
6045011300,"Census Tract 113, Mendocino County, California",2076,133,1138,157,938,171
6045011400,"Census Tract 114, Mendocino County, California",1531,122,1069,119,462,101
6045011500,"Census Tract 115, Mendocino County, California",2380,175,1109,180,1271,213
6045011600,"Census Tract 116, Mendocino County, California",2121,185,652,131,1469,200
6045011700,"Census Tract 117, Mendocino County, California",1455,113,1077,107,378,98
6045011800,"Census Tract 118, Mendocino County, California",844,90,461,93,383,120
6047000100,"Census Tract 1, Merced County, California",382,45,174,47,208,42
6047000200,"Census Tract 2, Merced County, California",3590,186,2608,195,982,193
6047000301,"Census Tract 3.01, Merced County, California",1294,121,794,145,500,143
6047000303,"Census Tract 3.03, Merced County, California",774,75,315,70,459,89
6047000304,"Census Tract 3.04, Merced County, California",2256,167,1486,205,770,183
6047000400,"Census Tract 4, Merced County, California",2993,199,2231,209,762,177
6047000503,"Census Tract 5.03, Merced County, California",637,74,386,69,251,73
6047000504,"Census Tract 5.04, Merced County, California",1470,127,672,116,798,122
6047000505,"Census Tract 5.05, Merced County, California",1701,122,921,154,780,153
6047000601,"Census Tract 6.01, Merced County, California",1662,125,876,132,786,153
6047000602,"Census Tract 6.02, Merced County, California",1115,85,749,97,366,109
6047000603,"Census Tract 6.03, Merced County, California",1832,167,931,140,901,168
6047000701,"Census Tract 7.01, Merced County, California",977,104,373,73,604,110
6047000702,"Census Tract 7.02, Merced County, California",1323,108,1187,130,136,72
6047000801,"Census Tract 8.01, Merced County, California",1334,123,477,80,857,145
6047000802,"Census Tract 8.02, Merced County, California",1338,96,1047,116,291,84
6047000901,"Census Tract 9.01, Merced County, California",1151,91,479,99,672,113
6047000902,"Census Tract 9.02, Merced County, California",1984,160,1532,206,452,137
6047000903,"Census Tract 9.03, Merced County, California",352,58,315,59,37,28
6047001002,"Census Tract 10.02, Merced County, California",3569,256,1831,256,1738,261
6047001003,"Census Tract 10.03, Merced County, California",1400,101,309,97,1091,146
6047001004,"Census Tract 10.04, Merced County, California",1785,139,322,74,1463,141
6047001005,"Census Tract 10.05, Merced County, California",814,99,358,96,456,91
6047001101,"Census Tract 11.01, Merced County, California",2148,140,1218,179,930,183
6047001102,"Census Tract 11.02, Merced County, California",806,71,587,71,219,81
6047001200,"Census Tract 12, Merced County, California",1814,108,1348,120,466,130
6047001301,"Census Tract 13.01, Merced County, California",1175,115,321,71,854,126
6047001302,"Census Tract 13.02, Merced County, California",1215,89,264,91,951,107
6047001401,"Census Tract 14.01, Merced County, California",1410,133,544,87,866,132
6047001402,"Census Tract 14.02, Merced County, California",1556,119,747,134,809,148
6047001501,"Census Tract 15.01, Merced County, California",814,74,530,107,284,105
6047001502,"Census Tract 15.02, Merced County, California",734,105,250,76,484,101
6047001503,"Census Tract 15.03, Merced County, California",1200,99,311,82,889,123
6047001601,"Census Tract 16.01, Merced County, California",967,116,58,31,909,113
6047001602,"Census Tract 16.02, Merced County, California",1542,123,716,178,826,152
6047001700,"Census Tract 17, Merced County, California",2090,170,1006,173,1084,188
6047001801,"Census Tract 18.01, Merced County, California",1085,102,879,95,206,97
6047001802,"Census Tract 18.02, Merced County, California",513,100,289,112,224,108
6047001901,"Census Tract 19.01, Merced County, California",1251,104,811,118,440,97
6047001902,"Census Tract 19.02, Merced County, California",765,59,479,59,286,63
6047002000,"Census Tract 20, Merced County, California",2643,242,1582,215,1061,199
6047002100,"Census Tract 21, Merced County, California",1081,116,554,102,527,140
6047002201,"Census Tract 22.01, Merced County, California",1928,175,767,125,1161,159
6047002202,"Census Tract 22.02, Merced County, California",2562,203,1866,223,696,200
6047002301,"Census Tract 23.01, Merced County, California",1859,149,1615,156,244,100
6047002302,"Census Tract 23.02, Merced County, California",3628,231,2471,291,1157,251
6047002400,"Census Tract 24, Merced County, California",2609,232,1622,265,987,163
6049000100,"Census Tract 1, Modoc County, California",1398,148,872,155,526,105
6049000200,"Census Tract 2, Modoc County, California",855,98,619,93,236,77
6049000300,"Census Tract 3, Modoc County, California",910,132,756,120,154,79
6049000400,"Census Tract 4, Modoc County, California",610,76,408,70,202,54
6051000100,"Census Tract 1, Mono County, California",2350,226,1598,220,752,249
6051000200,"Census Tract 2, Mono County, California",2664,393,1419,282,1245,316
6053000101,"Census Tract 1.01, Monterey County, California",519,70,385,82,134,60
6053000102,"Census Tract 1.02, Monterey County, California",2325,124,1564,182,761,164
6053000103,"Census Tract 1.03, Monterey County, California",1272,138,314,131,958,136
6053000104,"Census Tract 1.04, Monterey County, California",973,54,891,84,82,75
6053000200,"Census Tract 2, Monterey County, California",1693,88,887,113,806,140
6053000300,"Census Tract 3, Monterey County, California",1239,82,556,94,683,103
6053000400,"Census Tract 4, Monterey County, California",1978,200,777,147,1201,198
6053000500,"Census Tract 5, Monterey County, California",1945,143,732,147,1213,161
6053000600,"Census Tract 6, Monterey County, California",1443,98,541,143,902,161
6053000700,"Census Tract 7, Monterey County, California",2458,103,516,142,1942,159
6053000800,"Census Tract 8, Monterey County, California",1217,52,655,103,562,112
6053000900,"Census Tract 9, Monterey County, California",1135,78,353,58,782,90
6053001000,"Census Tract 10, Monterey County, California",242,94,95,51,147,80
6053001100,"Census Tract 11, Monterey County, California",1309,75,692,95,617,89
6053001200,"Census Tract 12, Monterey County, California",1135,114,716,84,419,101
6053001300,"Census Tract 13, Monterey County, California",952,65,174,51,778,73
6053001400,"Census Tract 14, Monterey County, California",1061,81,480,82,581,106
6053001500,"Census Tract 15, Monterey County, California",2471,201,1073,149,1398,196
6053001600,"Census Tract 16, Monterey County, California",1024,65,676,124,348,102
6053001700,"Census Tract 17, Monterey County, California",1280,81,552,125,728,133
6053001800,"Census Tract 18, Monterey County, California",2805,171,1233,146,1572,199
6053010101,"Census Tract 101.01, Monterey County, California",920,95,333,89,587,105
6053010102,"Census Tract 101.02, Monterey County, California",1039,59,875,78,164,66
6053010201,"Census Tract 102.01, Monterey County, California",1153,75,740,104,413,90
6053010202,"Census Tract 102.02, Monterey County, California",1286,78,1018,109,268,102
6053010302,"Census Tract 103.02, Monterey County, California",471,73,270,65,201,97
6053010303,"Census Tract 103.03, Monterey County, California",80,56,21,23,59,51
6053010304,"Census Tract 103.04, Monterey County, California",1625,155,1239,153,386,102
6053010305,"Census Tract 103.05, Monterey County, California",1551,99,1303,102,248,107
6053010400,"Census Tract 104, Monterey County, California",1347,127,586,129,761,149
6053010501,"Census Tract 105.01, Monterey County, California",2306,108,1846,167,460,165
6053010503,"Census Tract 105.03, Monterey County, California",2691,132,1040,194,1651,228
6053010504,"Census Tract 105.04, Monterey County, California",1501,108,785,139,716,149
6053010602,"Census Tract 106.02, Monterey County, California",1449,60,683,116,766,115
6053010603,"Census Tract 106.03, Monterey County, California",2144,86,1719,140,425,121
6053010604,"Census Tract 106.04, Monterey County, California",1227,69,857,113,370,108
6053010605,"Census Tract 106.05, Monterey County, California",839,53,523,101,316,86
6053010606,"Census Tract 106.06, Monterey County, California",1416,111,780,100,636,113
6053010701,"Census Tract 107.01, Monterey County, California",2625,133,2425,140,200,104
6053010702,"Census Tract 107.02, Monterey County, California",1631,114,1450,133,181,98
6053010801,"Census Tract 108.01, Monterey County, California",2393,178,1353,209,1040,185
6053010802,"Census Tract 108.02, Monterey County, California",245,54,118,35,127,43
6053010900,"Census Tract 109, Monterey County, California",0,132,0,132,0,132
6053011000,"Census Tract 110, Monterey County, California",2620,201,1834,226,786,198
6053011101,"Census Tract 111.01, Monterey County, California",1473,117,774,127,699,125
6053011102,"Census Tract 111.02, Monterey County, California",3102,234,2004,272,1098,251
6053011201,"Census Tract 112.01, Monterey County, California",2126,170,1342,173,784,163
6053011202,"Census Tract 112.02, Monterey County, California",1289,96,792,105,497,109
6053011301,"Census Tract 113.01, Monterey County, California",2307,174,1481,199,826,172
6053011302,"Census Tract 113.02, Monterey County, California",1215,153,428,98,787,134
6053011400,"Census Tract 114, Monterey County, California",1176,66,710,77,466,64
6053011500,"Census Tract 115, Monterey County, California",471,82,313,75,158,60
6053011600,"Census Tract 116, Monterey County, California",3752,165,2781,167,971,202
6053011700,"Census Tract 117, Monterey County, California",1742,195,1318,177,424,141
6053011800,"Census Tract 118, Monterey County, California",2108,175,1164,202,944,202
6053011900,"Census Tract 119, Monterey County, California",2047,175,1889,188,158,77
6053012000,"Census Tract 120, Monterey County, California",1258,86,679,138,579,131
6053012100,"Census Tract 121, Monterey County, California",898,66,582,72,316,77
6053012200,"Census Tract 122, Monterey County, California",1146,77,647,98,499,100
6053012301,"Census Tract 123.01, Monterey County, California",384,38,354,33,30,25
6053012302,"Census Tract 123.02, Monterey County, California",846,77,341,67,505,90
6053012401,"Census Tract 124.01, Monterey County, California",856,114,173,57,683,108
6053012402,"Census Tract 124.02, Monterey County, California",1383,115,725,114,658,115
6053012500,"Census Tract 125, Monterey County, California",2589,191,877,137,1712,162
6053012600,"Census Tract 126, Monterey County, California",50,37,0,132,50,37
6053012700,"Census Tract 127, Monterey County, California",1943,130,463,90,1480,142
6053012800,"Census Tract 128, Monterey County, California",2200,167,1658,174,542,128
6053013000,"Census Tract 130, Monterey County, California",1778,138,216,63,1562,131
6053013100,"Census Tract 131, Monterey County, California",558,83,0,132,558,83
6053013200,"Census Tract 132, Monterey County, California",1648,147,1404,159,244,88
6053013300,"Census Tract 133, Monterey County, California",2655,179,659,138,1996,217
6053013400,"Census Tract 134, Monterey County, California",703,40,510,43,193,43
6053013500,"Census Tract 135, Monterey County, California",1686,129,1190,142,496,117
6053013600,"Census Tract 136, Monterey County, California",1449,94,616,111,833,131
6053013700,"Census Tract 137, Monterey County, California",1458,78,423,105,1035,125
6053013800,"Census Tract 138, Monterey County, California",1677,123,1143,157,534,167
6053013900,"Census Tract 139, Monterey County, California",901,77,649,75,252,84
6053014000,"Census Tract 140, Monterey County, California",739,88,353,64,386,97
6053014101,"Census Tract 141.01, Monterey County, California",1202,114,75,31,1127,115
6053014102,"Census Tract 141.02, Monterey County, California",893,136,9,16,884,135
6053014103,"Census Tract 141.03, Monterey County, California",2580,212,358,84,2222,236
6053014200,"Census Tract 142, Monterey County, California",3098,177,1438,189,1660,169
6053014301,"Census Tract 143.01, Monterey County, California",1373,103,618,108,755,110
6053014302,"Census Tract 143.02, Monterey County, California",1566,102,641,101,925,128
6055200201,"Census Tract 2002.01, Napa County, California",1255,95,694,105,561,88
6055200202,"Census Tract 2002.02, Napa County, California",1061,78,345,82,716,113
6055200203,"Census Tract 2002.03, Napa County, California",826,95,366,108,460,142
6055200300,"Census Tract 2003, Napa County, California",2489,145,1615,177,874,147
6055200400,"Census Tract 2004, Napa County, California",1527,81,1109,88,418,91
6055200501,"Census Tract 2005.01, Napa County, California",1731,90,827,136,904,147
6055200502,"Census Tract 2005.02, Napa County, California",3032,220,1214,184,1818,271
6055200503,"Census Tract 2005.03, Napa County, California",738,58,174,51,564,70
6055200600,"Census Tract 2006, Napa County, California",3302,147,2302,173,1000,172
6055200701,"Census Tract 2007.01, Napa County, California",2490,157,1590,178,900,165
6055200702,"Census Tract 2007.02, Napa County, California",2392,129,1625,151,767,141
6055200703,"Census Tract 2007.03, Napa County, California",1101,65,1062,69,39,26
6055200801,"Census Tract 2008.01, Napa County, California",2406,130,1282,192,1124,203
6055200802,"Census Tract 2008.02, Napa County, California",2138,153,1209,150,929,159
6055200900,"Census Tract 2009, Napa County, California",8,13,0,132,8,13
6055201001,"Census Tract 2010.01, Napa County, California",2434,177,2136,193,298,120
6055201002,"Census Tract 2010.02, Napa County, California",2675,158,2349,168,326,104
6055201100,"Census Tract 2011, Napa County, California",1584,150,1295,115,289,118
6055201200,"Census Tract 2012, Napa County, California",1929,148,1656,167,273,116
6055201300,"Census Tract 2013, Napa County, California",1423,206,1050,190,373,93
6055201400,"Census Tract 2014, Napa County, California",3074,249,2690,235,384,119
6055201500,"Census Tract 2015, Napa County, California",870,127,565,103,305,112
6055201600,"Census Tract 2016, Napa County, California",2442,160,1410,177,1032,186
6055201700,"Census Tract 2017, Napa County, California",1930,160,1056,148,874,147
6055201800,"Census Tract 2018, Napa County, California",698,90,592,101,106,48
6055201900,"Census Tract 2019, Napa County, California",498,92,340,83,158,81
6055202000,"Census Tract 2020, Napa County, California",2041,235,1241,239,800,127
6057000102,"Census Tract 1.02, Nevada County, California",2619,155,2391,174,228,107
6057000103,"Census Tract 1.03, Nevada County, California",3176,166,2776,190,400,150
6057000104,"Census Tract 1.04, Nevada County, California",1578,83,1418,97,160,63
6057000105,"Census Tract 1.05, Nevada County, California",1023,117,836,114,187,99
6057000200,"Census Tract 2, Nevada County, California",995,73,890,84,105,60
6057000300,"Census Tract 3, Nevada County, California",919,77,814,88,105,55
6057000401,"Census Tract 4.01, Nevada County, California",2494,148,2153,155,341,126
6057000402,"Census Tract 4.02, Nevada County, California",2546,163,2124,196,422,195
6057000501,"Census Tract 5.01, Nevada County, California",2382,185,1315,177,1067,177
6057000502,"Census Tract 5.02, Nevada County, California",2043,151,1262,171,781,145
6057000600,"Census Tract 6, Nevada County, California",2590,189,964,120,1626,185
6057000701,"Census Tract 7.01, Nevada County, California",3202,159,2676,198,526,194
6057000702,"Census Tract 7.02, Nevada County, California",1587,95,1304,118,283,92
6057000801,"Census Tract 8.01, Nevada County, California",2028,141,1667,174,361,142
6057000802,"Census Tract 8.02, Nevada County, California",2568,252,1779,211,789,185
6057000900,"Census Tract 9, Nevada County, California",1462,170,1136,145,326,121
6057001201,"Census Tract 12.01, Nevada County, California",3790,255,2758,273,1032,263
6057001202,"Census Tract 12.02, Nevada County, California",2540,325,1798,272,742,225
6059001101,"Census Tract 11.01, Orange County, California",1468,85,1156,98,312,91
6059001102,"Census Tract 11.02, Orange County, California",989,59,455,109,534,102
6059001103,"Census Tract 11.03, Orange County, California",1389,64,473,103,916,108
6059001201,"Census Tract 12.01, Orange County, California",1316,87,437,91,879,97
6059001202,"Census Tract 12.02, Orange County, California",868,45,479,72,389,72
6059001301,"Census Tract 13.01, Orange County, California",2146,149,1403,178,743,169
6059001303,"Census Tract 13.03, Orange County, California",1756,69,905,141,851,146
6059001304,"Census Tract 13.04, Orange County, California",1080,58,550,83,530,88
6059001401,"Census Tract 14.01, Orange County, California",1716,75,834,139,882,140
6059001402,"Census Tract 14.02, Orange County, California",1536,47,857,102,679,100
6059001403,"Census Tract 14.03, Orange County, California",1080,39,985,69,95,68
6059001404,"Census Tract 14.04, Orange County, California",956,55,465,93,491,93
6059001501,"Census Tract 15.01, Orange County, California",2277,122,2180,140,97,73
6059001503,"Census Tract 15.03, Orange County, California",1659,100,1062,133,597,117
6059001504,"Census Tract 15.04, Orange County, California",1722,76,960,156,762,151
6059001505,"Census Tract 15.05, Orange County, California",2335,94,1767,160,568,155
6059001506,"Census Tract 15.06, Orange County, California",1564,76,998,110,566,115
6059001507,"Census Tract 15.07, Orange County, California",1894,95,758,84,1136,106
6059001601,"Census Tract 16.01, Orange County, California",2767,101,1978,156,789,142
6059001602,"Census Tract 16.02, Orange County, California",1815,48,1628,84,187,76
6059001704,"Census Tract 17.04, Orange County, California",2242,65,1636,120,606,121
6059001705,"Census Tract 17.05, Orange County, California",1360,65,894,80,466,80
6059001706,"Census Tract 17.06, Orange County, California",1268,88,1028,111,240,74
6059001707,"Census Tract 17.07, Orange County, California",2397,98,1876,162,521,165
6059001708,"Census Tract 17.08, Orange County, California",1250,65,1114,101,136,72
6059001801,"Census Tract 18.01, Orange County, California",1523,62,290,76,1233,93
6059001802,"Census Tract 18.02, Orange County, California",2127,58,545,126,1582,137
6059001901,"Census Tract 19.01, Orange County, California",762,44,577,107,185,85
6059001902,"Census Tract 19.02, Orange County, California",804,25,599,61,205,63
6059001903,"Census Tract 19.03, Orange County, California",926,40,688,83,238,77
6059011000,"Census Tract 110, Orange County, California",2286,117,1377,143,909,156
6059011101,"Census Tract 111.01, Orange County, California",1267,60,622,93,645,104
6059011102,"Census Tract 111.02, Orange County, California",1161,40,857,98,304,86
6059011200,"Census Tract 112, Orange County, California",1496,82,856,85,640,97
6059011300,"Census Tract 113, Orange County, California",1854,109,470,82,1384,136
6059011401,"Census Tract 114.01, Orange County, California",709,54,452,63,257,72
6059011402,"Census Tract 114.02, Orange County, California",853,19,778,42,75,41
6059011403,"Census Tract 114.03, Orange County, California",1826,84,810,143,1016,138
6059011502,"Census Tract 115.02, Orange County, California",1373,79,579,121,794,115
6059011503,"Census Tract 115.03, Orange County, California",534,58,460,58,74,60
6059011504,"Census Tract 115.04, Orange County, California",1858,158,248,79,1610,172
6059011601,"Census Tract 116.01, Orange County, California",2262,115,267,85,1995,127
6059011602,"Census Tract 116.02, Orange County, California",1665,89,992,129,673,129
6059011707,"Census Tract 117.07, Orange County, California",2278,88,1483,155,795,123
6059011708,"Census Tract 117.08, Orange County, California",1739,110,508,66,1231,117
6059011709,"Census Tract 117.09, Orange County, California",1454,46,1385,64,69,52
6059011710,"Census Tract 117.10, Orange County, California",1105,60,945,68,160,67
6059011711,"Census Tract 117.11, Orange County, California",2670,101,490,122,2180,143
6059011712,"Census Tract 117.12, Orange County, California",1487,81,706,95,781,109
6059011714,"Census Tract 117.14, Orange County, California",64,45,0,132,64,45
6059011715,"Census Tract 117.15, Orange County, California",2479,148,1696,141,783,189
6059011716,"Census Tract 117.16, Orange County, California",1559,59,1486,77,73,58
6059011717,"Census Tract 117.17, Orange County, California",924,25,664,73,260,69
6059011718,"Census Tract 117.18, Orange County, California",1118,73,1014,102,104,65
6059011720,"Census Tract 117.20, Orange County, California",1443,75,297,68,1146,89
6059011721,"Census Tract 117.21, Orange County, California",1463,70,326,94,1137,103
6059011722,"Census Tract 117.22, Orange County, California",1244,80,554,74,690,93
6059021802,"Census Tract 218.02, Orange County, California",2597,109,1711,149,886,159
6059021807,"Census Tract 218.07, Orange County, California",1229,74,845,100,384,101
6059021809,"Census Tract 218.09, Orange County, California",1019,26,711,86,308,83
6059021810,"Census Tract 218.10, Orange County, California",1219,34,1123,79,96,67
6059021812,"Census Tract 218.12, Orange County, California",1841,168,1270,129,571,154
6059021813,"Census Tract 218.13, Orange County, California",0,132,0,132,0,132
6059021814,"Census Tract 218.14, Orange County, California",2494,107,1398,135,1096,176
6059021815,"Census Tract 218.15, Orange County, California",2564,68,2374,103,190,77
6059021816,"Census Tract 218.16, Orange County, California",1857,69,1739,92,118,66
6059021817,"Census Tract 218.17, Orange County, California",1368,62,1030,134,338,125
6059021820,"Census Tract 218.20, Orange County, California",1359,51,1231,83,128,60
6059021821,"Census Tract 218.21, Orange County, California",2239,117,1264,151,975,156
6059021822,"Census Tract 218.22, Orange County, California",1974,63,1578,148,396,154
6059021823,"Census Tract 218.23, Orange County, California",1009,67,847,86,162,73
6059021824,"Census Tract 218.24, Orange County, California",855,51,811,60,44,33
6059021825,"Census Tract 218.25, Orange County, California",1095,27,938,53,157,48
6059021826,"Census Tract 218.26, Orange County, California",1007,57,601,91,406,96
6059021827,"Census Tract 218.27, Orange County, California",1053,58,918,65,135,56
6059021828,"Census Tract 218.28, Orange County, California",1327,35,1295,48,32,33
6059021829,"Census Tract 218.29, Orange County, California",1687,82,1625,77,62,51
6059021830,"Census Tract 218.30, Orange County, California",2011,66,1901,79,110,58
6059021903,"Census Tract 219.03, Orange County, California",1113,64,922,110,191,93
6059021905,"Census Tract 219.05, Orange County, California",1692,78,1481,94,211,81
6059021912,"Census Tract 219.12, Orange County, California",1526,41,1474,67,52,53
6059021913,"Census Tract 219.13, Orange County, California",2053,118,1386,148,667,162
6059021914,"Census Tract 219.14, Orange County, California",1392,68,1087,80,305,90
6059021915,"Census Tract 219.15, Orange County, California",1411,64,1318,89,93,52
6059021916,"Census Tract 219.16, Orange County, California",1294,83,1050,78,244,80
6059021917,"Census Tract 219.17, Orange County, California",1171,86,1077,88,94,59
6059021918,"Census Tract 219.18, Orange County, California",1763,73,1483,116,280,103
6059021919,"Census Tract 219.19, Orange County, California",1009,75,805,84,204,81
6059021920,"Census Tract 219.20, Orange County, California",2399,117,2266,119,133,72
6059021921,"Census Tract 219.21, Orange County, California",1399,39,1322,73,77,77
6059021922,"Census Tract 219.22, Orange County, California",2097,137,1258,132,839,148
6059021923,"Census Tract 219.23, Orange County, California",2278,50,2037,131,241,122
6059021924,"Census Tract 219.24, Orange County, California",1413,80,1071,82,342,101
6059032002,"Census Tract 320.02, Orange County, California",2007,100,1799,121,208,83
6059032003,"Census Tract 320.03, Orange County, California",1590,39,1470,86,120,77
6059032011,"Census Tract 320.11, Orange County, California",876,78,745,102,131,82
6059032012,"Census Tract 320.12, Orange County, California",1284,28,1031,102,253,90
6059032013,"Census Tract 320.13, Orange County, California",1992,83,1000,99,992,120
6059032014,"Census Tract 320.14, Orange County, California",1823,110,1343,142,480,126
6059032015,"Census Tract 320.15, Orange County, California",1941,86,1500,89,441,105
6059032020,"Census Tract 320.20, Orange County, California",1907,37,1594,91,313,87
6059032022,"Census Tract 320.22, Orange County, California",2047,101,1123,152,924,152
6059032023,"Census Tract 320.23, Orange County, California",3594,153,2947,167,647,121
6059032027,"Census Tract 320.27, Orange County, California",2062,124,1282,141,780,150
6059032028,"Census Tract 320.28, Orange County, California",1227,86,764,123,463,109
6059032029,"Census Tract 320.29, Orange County, California",1406,66,1228,90,178,76
6059032030,"Census Tract 320.30, Orange County, California",1233,50,1110,90,123,77
6059032031,"Census Tract 320.31, Orange County, California",1093,71,1013,81,80,50
6059032032,"Census Tract 320.32, Orange County, California",1030,28,920,68,110,57
6059032033,"Census Tract 320.33, Orange County, California",1430,66,737,90,693,98
6059032034,"Census Tract 320.34, Orange County, California",1828,44,1766,60,62,46
6059032035,"Census Tract 320.35, Orange County, California",1009,75,883,84,126,60
6059032036,"Census Tract 320.36, Orange County, California",1241,31,1081,82,160,77
6059032037,"Census Tract 320.37, Orange County, California",2544,96,2232,147,312,138
6059032038,"Census Tract 320.38, Orange County, California",2091,81,1915,121,176,94
6059032039,"Census Tract 320.39, Orange County, California",2123,104,1686,131,437,144
6059032040,"Census Tract 320.40, Orange County, California",890,16,845,41,45,36
6059032041,"Census Tract 320.41, Orange County, California",381,59,356,61,25,41
6059032042,"Census Tract 320.42, Orange County, California",1791,50,1457,120,334,111
6059032043,"Census Tract 320.43, Orange County, California",1230,38,1208,44,22,30
6059032044,"Census Tract 320.44, Orange County, California",2200,117,2051,151,149,101
6059032045,"Census Tract 320.45, Orange County, California",1096,41,1028,62,68,46
6059032046,"Census Tract 320.46, Orange County, California",2150,79,2071,84,79,55
6059032047,"Census Tract 320.47, Orange County, California",1770,34,1014,125,756,138
6059032048,"Census Tract 320.48, Orange County, California",2240,47,2129,78,111,66
6059032049,"Census Tract 320.49, Orange County, California",3080,119,2358,150,722,158
6059032050,"Census Tract 320.50, Orange County, California",1715,57,1458,98,257,81
6059032051,"Census Tract 320.51, Orange County, California",1916,95,1073,145,843,162
6059032052,"Census Tract 320.52, Orange County, California",6817,272,5453,286,1364,247
6059032053,"Census Tract 320.53, Orange County, California",3061,132,2072,221,989,228
6059032054,"Census Tract 320.54, Orange County, California",2266,95,935,139,1331,165
6059032055,"Census Tract 320.55, Orange County, California",1486,102,932,93,554,118
6059032056,"Census Tract 320.56, Orange County, California",2246,105,1954,117,292,105
6059042103,"Census Tract 421.03, Orange County, California",2880,192,1767,200,1113,216
6059042106,"Census Tract 421.06, Orange County, California",599,83,480,68,119,80
6059042107,"Census Tract 421.07, Orange County, California",1278,99,423,88,855,119
6059042108,"Census Tract 421.08, Orange County, California",2687,160,673,174,2014,199
6059042109,"Census Tract 421.09, Orange County, California",1968,105,1265,145,703,136
6059042111,"Census Tract 421.11, Orange County, California",2142,93,2066,108,76,59
6059042112,"Census Tract 421.12, Orange County, California",2118,78,1802,101,316,87
6059042113,"Census Tract 421.13, Orange County, California",2017,104,1508,122,509,117
6059042114,"Census Tract 421.14, Orange County, California",1721,109,1050,119,671,123
6059042201,"Census Tract 422.01, Orange County, California",2358,143,1670,156,688,162
6059042203,"Census Tract 422.03, Orange County, California",2321,137,1888,180,433,145
6059042205,"Census Tract 422.05, Orange County, California",2363,120,1980,155,383,124
6059042206,"Census Tract 422.06, Orange County, California",1357,84,958,108,399,90
6059042305,"Census Tract 423.05, Orange County, California",1531,148,1136,157,395,135
6059042307,"Census Tract 423.07, Orange County, California",2337,104,1724,142,613,137
6059042310,"Census Tract 423.10, Orange County, California",2589,177,2027,214,562,173
6059042311,"Census Tract 423.11, Orange County, California",2146,66,1977,94,169,71
6059042312,"Census Tract 423.12, Orange County, California",1615,124,1042,148,573,142
6059042313,"Census Tract 423.13, Orange County, California",3129,198,1092,171,2037,236
6059042315,"Census Tract 423.15, Orange County, California",2299,112,2064,127,235,113
6059042317,"Census Tract 423.17, Orange County, California",1283,88,1178,95,105,56
6059042319,"Census Tract 423.19, Orange County, California",1155,39,1085,61,70,51
6059042320,"Census Tract 423.20, Orange County, California",2394,135,1255,178,1139,190
6059042323,"Census Tract 423.23, Orange County, California",2435,192,1577,142,858,186
6059042324,"Census Tract 423.24, Orange County, California",2168,138,1540,141,628,154
6059042325,"Census Tract 423.25, Orange County, California",1439,98,963,113,476,113
6059042326,"Census Tract 423.26, Orange County, California",1843,79,1379,101,464,101
6059042327,"Census Tract 423.27, Orange County, California",1762,74,1556,93,206,77
6059042328,"Census Tract 423.28, Orange County, California",772,65,732,65,40,37
6059042329,"Census Tract 423.29, Orange County, California",1580,76,1324,98,256,98
6059042330,"Census Tract 423.30, Orange County, California",2185,110,1003,139,1182,160
6059042331,"Census Tract 423.31, Orange County, California",2158,97,1400,145,758,157
6059042332,"Census Tract 423.32, Orange County, California",1923,118,1656,149,267,113
6059042333,"Census Tract 423.33, Orange County, California",1284,65,1263,67,21,25
6059042334,"Census Tract 423.34, Orange County, California",2216,123,1437,194,779,191
6059042335,"Census Tract 423.35, Orange County, California",2221,103,1392,152,829,147
6059042336,"Census Tract 423.36, Orange County, California",1576,70,1414,98,162,69
6059042337,"Census Tract 423.37, Orange County, California",1384,64,1215,95,169,80
6059042338,"Census Tract 423.38, Orange County, California",2055,132,1493,133,562,124
6059042339,"Census Tract 423.39, Orange County, California",1365,105,808,97,557,114
6059052404,"Census Tract 524.04, Orange County, California",29,7,29,7,0,132
6059052408,"Census Tract 524.08, Orange County, California",2148,62,1857,127,291,113
6059052410,"Census Tract 524.10, Orange County, California",2006,99,1527,120,479,105
6059052411,"Census Tract 524.11, Orange County, California",1318,36,1115,96,203,93
6059052415,"Census Tract 524.15, Orange County, California",1292,48,1074,101,218,92
6059052416,"Census Tract 524.16, Orange County, California",1229,71,936,104,293,106
6059052417,"Census Tract 524.17, Orange County, California",2313,109,2110,131,203,83
6059052418,"Census Tract 524.18, Orange County, California",3135,166,1327,161,1808,183
6059052419,"Census Tract 524.19, Orange County, California",1154,42,1089,52,65,30
6059052420,"Census Tract 524.20, Orange County, California",6829,200,4796,252,2033,215
6059052421,"Census Tract 524.21, Orange County, California",2005,62,1598,127,407,115
6059052422,"Census Tract 524.22, Orange County, California",1425,83,1054,97,371,92
6059052423,"Census Tract 524.23, Orange County, California",1948,117,609,88,1339,127
6059052424,"Census Tract 524.24, Orange County, California",1850,56,1291,120,559,116
6059052425,"Census Tract 524.25, Orange County, California",2240,154,1285,185,955,198
6059052426,"Census Tract 524.26, Orange County, California",1857,93,1460,126,397,102
6059052427,"Census Tract 524.27, Orange County, California",1688,62,1426,97,262,98
6059052428,"Census Tract 524.28, Orange County, California",2103,84,1847,122,256,97
6059052502,"Census Tract 525.02, Orange County, California",1948,82,1683,116,265,113
6059052505,"Census Tract 525.05, Orange County, California",1817,163,1310,165,507,129
6059052506,"Census Tract 525.06, Orange County, California",910,30,798,63,112,64
6059052511,"Census Tract 525.11, Orange County, California",2097,148,1286,152,811,132
6059052513,"Census Tract 525.13, Orange County, California",2382,111,1258,139,1124,162
6059052514,"Census Tract 525.14, Orange County, California",2153,86,1099,153,1054,162
6059052515,"Census Tract 525.15, Orange County, California",2888,191,1500,171,1388,196
6059052517,"Census Tract 525.17, Orange County, California",4225,158,1904,223,2321,247
6059052518,"Census Tract 525.18, Orange County, California",710,86,0,132,710,86
6059052519,"Census Tract 525.19, Orange County, California",1569,92,1107,119,462,111
6059052520,"Census Tract 525.20, Orange County, California",1377,35,850,95,527,95
6059052521,"Census Tract 525.21, Orange County, California",1964,138,496,105,1468,168
6059052522,"Census Tract 525.22, Orange County, California",1434,66,584,90,850,106
6059052523,"Census Tract 525.23, Orange County, California",1552,65,754,97,798,106
6059052524,"Census Tract 525.24, Orange County, California",2802,113,1509,149,1293,178
6059052525,"Census Tract 525.25, Orange County, California",5423,199,2850,195,2573,227
6059052526,"Census Tract 525.26, Orange County, California",1370,45,1202,96,168,77
6059052527,"Census Tract 525.27, Orange County, California",2765,102,1781,192,984,202
6059052528,"Census Tract 525.28, Orange County, California",1240,69,770,89,470,101
6059062604,"Census Tract 626.04, Orange County, California",5724,228,3546,275,2178,236
6059062605,"Census Tract 626.05, Orange County, California",1917,172,499,150,1418,212
6059062610,"Census Tract 626.10, Orange County, California",3177,183,659,135,2518,216
6059062611,"Census Tract 626.11, Orange County, California",1512,107,409,130,1103,144
6059062612,"Census Tract 626.12, Orange County, California",2754,118,1943,176,811,199
6059062614,"Census Tract 626.14, Orange County, California",3186,173,753,87,2433,183
6059062619,"Census Tract 626.19, Orange County, California",1834,118,1224,142,610,132
6059062620,"Census Tract 626.20, Orange County, California",2178,200,1682,191,496,152
6059062621,"Census Tract 626.21, Orange County, California",1851,126,1597,140,254,102
6059062622,"Census Tract 626.22, Orange County, California",2774,167,1952,235,822,233
6059062623,"Census Tract 626.23, Orange County, California",4472,182,3145,255,1327,215
6059062625,"Census Tract 626.25, Orange County, California",1880,171,1679,159,201,77
6059062626,"Census Tract 626.26, Orange County, California",893,63,201,75,692,80
6059062627,"Census Tract 626.27, Orange County, California",1325,91,276,69,1049,101
6059062628,"Census Tract 626.28, Orange County, California",987,56,573,68,414,74
6059062629,"Census Tract 626.29, Orange County, California",886,73,756,128,130,117
6059062630,"Census Tract 626.30, Orange County, California",742,66,589,102,153,86
6059062631,"Census Tract 626.31, Orange County, California",1259,75,1241,78,18,21
6059062632,"Census Tract 626.32, Orange County, California",1903,147,1537,183,366,124
6059062633,"Census Tract 626.33, Orange County, California",1367,70,1276,97,91,74
6059062634,"Census Tract 626.34, Orange County, California",1813,69,1469,125,344,126
6059062635,"Census Tract 626.35, Orange County, California",1519,67,1266,94,253,88
6059062636,"Census Tract 626.36, Orange County, California",1372,56,609,92,763,107
6059062637,"Census Tract 626.37, Orange County, California",1733,119,385,67,1348,106
6059062638,"Census Tract 626.38, Orange County, California",2354,118,1402,167,952,163
6059062639,"Census Tract 626.39, Orange County, California",2231,103,1668,131,563,132
6059062640,"Census Tract 626.40, Orange County, California",1401,89,882,122,519,128
6059062641,"Census Tract 626.41, Orange County, California",1463,93,891,123,572,121
6059062642,"Census Tract 626.42, Orange County, California",1194,72,1107,79,87,59
6059062643,"Census Tract 626.43, Orange County, California",1953,115,1739,127,214,88
6059062644,"Census Tract 626.44, Orange County, California",2808,149,1346,110,1462,181
6059062645,"Census Tract 626.45, Orange County, California",2406,100,1547,145,859,136
6059062646,"Census Tract 626.46, Orange County, California",2789,177,2231,181,558,149
6059062647,"Census Tract 626.47, Orange County, California",2297,190,1525,184,772,191
6059062701,"Census Tract 627.01, Orange County, California",1347,108,846,109,501,113
6059062702,"Census Tract 627.02, Orange County, California",2179,153,966,135,1213,169
6059062800,"Census Tract 628, Orange County, California",2048,198,935,131,1113,194
6059062900,"Census Tract 629, Orange County, California",806,63,690,65,116,54
6059063004,"Census Tract 630.04, Orange County, California",2823,200,1411,178,1412,195
6059063005,"Census Tract 630.05, Orange County, California",774,131,284,69,490,102
6059063006,"Census Tract 630.06, Orange County, California",1450,111,747,101,703,112
6059063007,"Census Tract 630.07, Orange County, California",2923,142,1841,194,1082,207
6059063008,"Census Tract 630.08, Orange County, California",471,71,265,69,206,72
6059063009,"Census Tract 630.09, Orange County, California",625,63,556,67,69,66
6059063010,"Census Tract 630.10, Orange County, California",2980,110,1346,118,1634,130
6059063101,"Census Tract 631.01, Orange County, California",1126,87,271,69,855,86
6059063102,"Census Tract 631.02, Orange County, California",2681,154,1538,167,1143,172
6059063103,"Census Tract 631.03, Orange County, California",1103,30,712,107,391,100
6059063201,"Census Tract 632.01, Orange County, California",1595,100,693,102,902,136
6059063202,"Census Tract 632.02, Orange County, California",1459,93,633,99,826,125
6059063301,"Census Tract 633.01, Orange County, California",1290,120,333,94,957,125
6059063302,"Census Tract 633.02, Orange County, California",1790,83,889,130,901,140
6059063400,"Census Tract 634, Orange County, California",1651,122,1280,115,371,116
6059063500,"Census Tract 635, Orange County, California",2427,233,1042,174,1385,216
6059063601,"Census Tract 636.01, Orange County, California",1396,44,998,117,398,103
6059063603,"Census Tract 636.03, Orange County, California",2697,162,1341,182,1356,209
6059063604,"Census Tract 636.04, Orange County, California",1374,101,490,72,884,117
6059063605,"Census Tract 636.05, Orange County, California",1410,80,194,67,1216,96
6059063701,"Census Tract 637.01, Orange County, California",1763,72,212,71,1551,94
6059063702,"Census Tract 637.02, Orange County, California",2075,202,376,110,1699,198
6059063802,"Census Tract 638.02, Orange County, California",1008,52,798,86,210,69
6059063803,"Census Tract 638.03, Orange County, California",1655,63,1030,101,625,107
6059063805,"Census Tract 638.05, Orange County, California",905,25,814,69,91,60
6059063806,"Census Tract 638.06, Orange County, California",1341,84,893,110,448,91
6059063807,"Census Tract 638.07, Orange County, California",1845,125,291,65,1554,154
6059063808,"Census Tract 638.08, Orange County, California",1593,69,409,75,1184,99
6059063902,"Census Tract 639.02, Orange County, California",2392,182,546,109,1846,216
6059063903,"Census Tract 639.03, Orange County, California",1184,59,810,100,374,99
6059063904,"Census Tract 639.04, Orange County, California",1337,68,855,88,482,77
6059063905,"Census Tract 639.05, Orange County, California",1855,91,917,97,938,104
6059063906,"Census Tract 639.06, Orange County, California",2276,136,597,156,1679,182
6059063907,"Census Tract 639.07, Orange County, California",2430,174,1129,144,1301,201
6059063908,"Census Tract 639.08, Orange County, California",2513,116,893,141,1620,166
6059074003,"Census Tract 740.03, Orange County, California",664,67,307,66,357,86
6059074004,"Census Tract 740.04, Orange County, California",2331,81,1256,162,1075,158
6059074005,"Census Tract 740.05, Orange County, California",1510,46,758,105,752,109
6059074006,"Census Tract 740.06, Orange County, California",1907,101,758,131,1149,152
6059074102,"Census Tract 741.02, Orange County, California",1365,57,994,108,371,100
6059074103,"Census Tract 741.03, Orange County, California",950,39,846,78,104,62
6059074106,"Census Tract 741.06, Orange County, California",1922,83,998,140,924,135
6059074107,"Census Tract 741.07, Orange County, California",2569,140,898,158,1671,176
6059074108,"Census Tract 741.08, Orange County, California",892,69,566,90,326,95
6059074109,"Census Tract 741.09, Orange County, California",694,39,419,104,275,99
6059074110,"Census Tract 741.10, Orange County, California",981,29,800,81,181,84
6059074111,"Census Tract 741.11, Orange County, California",1358,76,1134,103,224,96
6059074200,"Census Tract 742, Orange County, California",1762,73,1062,143,700,142
6059074300,"Census Tract 743, Orange County, California",821,43,546,83,275,84
6059074403,"Census Tract 744.03, Orange County, California",1302,64,316,94,986,108
6059074405,"Census Tract 744.05, Orange County, California",1403,83,256,69,1147,103
6059074406,"Census Tract 744.06, Orange County, California",822,55,300,82,522,100
6059074407,"Census Tract 744.07, Orange County, California",1875,62,368,92,1507,99
6059074408,"Census Tract 744.08, Orange County, California",1534,97,458,102,1076,142
6059074501,"Census Tract 745.01, Orange County, California",1414,55,485,96,929,106
6059074502,"Census Tract 745.02, Orange County, California",1000,59,467,85,533,97
6059074601,"Census Tract 746.01, Orange County, California",1696,77,712,129,984,136
6059074602,"Census Tract 746.02, Orange County, California",1685,99,848,146,837,148
6059074701,"Census Tract 747.01, Orange County, California",1443,63,843,111,600,108
6059074702,"Census Tract 747.02, Orange County, California",1124,47,657,99,467,107
6059074801,"Census Tract 748.01, Orange County, California",1015,47,532,89,483,95
6059074802,"Census Tract 748.02, Orange County, California",1283,62,859,110,424,115
6059074803,"Census Tract 748.03, Orange County, California",1881,50,1311,140,570,142
6059074805,"Census Tract 748.05, Orange County, California",1009,52,312,71,697,87
6059074806,"Census Tract 748.06, Orange County, California",935,43,413,60,522,61
6059074901,"Census Tract 749.01, Orange County, California",1795,113,722,109,1073,142
6059074902,"Census Tract 749.02, Orange County, California",1277,30,356,82,921,91
6059075002,"Census Tract 750.02, Orange County, California",2277,98,335,117,1942,136
6059075003,"Census Tract 750.03, Orange County, California",1687,104,62,44,1625,118
6059075004,"Census Tract 750.04, Orange County, California",1285,68,136,70,1149,91
6059075100,"Census Tract 751, Orange County, California",2000,117,938,165,1062,169
6059075201,"Census Tract 752.01, Orange County, California",1187,28,671,108,516,114
6059075202,"Census Tract 752.02, Orange County, California",1141,74,691,93,450,100
6059075301,"Census Tract 753.01, Orange County, California",1596,60,740,102,856,97
6059075302,"Census Tract 753.02, Orange County, California",1121,57,828,101,293,88
6059075303,"Census Tract 753.03, Orange County, California",1174,65,890,69,284,73
6059075401,"Census Tract 754.01, Orange County, California",1181,73,1124,84,57,46
6059075403,"Census Tract 754.03, Orange County, California",2540,51,1582,198,958,197
6059075404,"Census Tract 754.04, Orange County, California",2131,116,960,126,1171,151
6059075405,"Census Tract 754.05, Orange County, California",1016,32,643,69,373,70
6059075504,"Census Tract 755.04, Orange County, California",1550,75,982,143,568,117
6059075505,"Census Tract 755.05, Orange County, California",1358,77,514,99,844,101
6059075506,"Census Tract 755.06, Orange County, California",1254,31,958,85,296,85
6059075507,"Census Tract 755.07, Orange County, California",1758,119,460,107,1298,144
6059075512,"Census Tract 755.12, Orange County, California",1002,108,360,87,642,116
6059075513,"Census Tract 755.13, Orange County, California",1489,75,653,117,836,126
6059075514,"Census Tract 755.14, Orange County, California",1254,58,169,69,1085,79
6059075515,"Census Tract 755.15, Orange County, California",3121,202,1099,160,2022,198
6059075603,"Census Tract 756.03, Orange County, California",1732,49,1436,90,296,75
6059075604,"Census Tract 756.04, Orange County, California",2901,104,2763,113,138,58
6059075605,"Census Tract 756.05, Orange County, California",2227,91,1971,130,256,108
6059075606,"Census Tract 756.06, Orange County, California",2406,100,2328,139,78,110
6059075607,"Census Tract 756.07, Orange County, California",2742,143,1664,187,1078,204
6059075701,"Census Tract 757.01, Orange County, California",2180,112,1349,147,831,154
6059075702,"Census Tract 757.02, Orange County, California",1347,45,1229,93,118,74
6059075703,"Census Tract 757.03, Orange County, California",1569,72,1486,91,83,49
6059075805,"Census Tract 758.05, Orange County, California",1350,59,709,96,641,100
6059075806,"Census Tract 758.06, Orange County, California",2061,85,1083,134,978,136
6059075807,"Census Tract 758.07, Orange County, California",1179,62,963,74,216,67
6059075808,"Census Tract 758.08, Orange County, California",1208,35,1149,49,59,39
6059075809,"Census Tract 758.09, Orange County, California",1151,84,1135,87,16,22
6059075810,"Census Tract 758.10, Orange County, California",1015,71,953,88,62,45
6059075811,"Census Tract 758.11, Orange County, California",757,60,447,48,310,65
6059075812,"Census Tract 758.12, Orange County, California",1860,70,1068,108,792,106
6059075813,"Census Tract 758.13, Orange County, California",1643,94,1495,141,148,99
6059075814,"Census Tract 758.14, Orange County, California",1156,34,975,69,181,68
6059075815,"Census Tract 758.15, Orange County, California",1545,76,1145,103,400,119
6059075816,"Census Tract 758.16, Orange County, California",1184,60,682,86,502,83
6059075901,"Census Tract 759.01, Orange County, California",1552,98,572,131,980,139
6059075902,"Census Tract 759.02, Orange County, California",2724,95,528,125,2196,147
6059076000,"Census Tract 760, Orange County, California",3021,137,1111,198,1910,225
6059076101,"Census Tract 761.01, Orange County, California",1715,83,999,111,716,118
6059076102,"Census Tract 761.02, Orange County, California",1587,103,271,98,1316,142
6059076103,"Census Tract 761.03, Orange County, California",2412,94,1025,187,1387,182
6059076201,"Census Tract 762.01, Orange County, California",2028,86,1546,164,482,152
6059076202,"Census Tract 762.02, Orange County, California",1901,92,1196,122,705,131
6059076204,"Census Tract 762.04, Orange County, California",1008,117,392,91,616,99
6059076205,"Census Tract 762.05, Orange County, California",1594,77,1066,95,528,109
6059076206,"Census Tract 762.06, Orange County, California",1527,74,1165,91,362,93
6059076208,"Census Tract 762.08, Orange County, California",1582,78,1117,137,465,131
6059086301,"Census Tract 863.01, Orange County, California",1698,105,1160,130,538,146
6059086303,"Census Tract 863.03, Orange County, California",1660,90,900,109,760,118
6059086304,"Census Tract 863.04, Orange County, California",1693,76,649,100,1044,124
6059086305,"Census Tract 863.05, Orange County, California",1122,36,1014,88,108,77
6059086306,"Census Tract 863.06, Orange County, California",1194,93,624,98,570,122
6059086402,"Census Tract 864.02, Orange County, California",1314,87,936,109,378,105
6059086404,"Census Tract 864.04, Orange County, California",1408,79,744,86,664,103
6059086405,"Census Tract 864.05, Orange County, California",1622,62,640,97,982,116
6059086406,"Census Tract 864.06, Orange County, California",1385,60,360,62,1025,74
6059086407,"Census Tract 864.07, Orange County, California",2051,95,999,162,1052,152
6059086501,"Census Tract 865.01, Orange County, California",1099,79,506,102,593,116
6059086502,"Census Tract 865.02, Orange County, California",1291,84,577,116,714,134
6059086601,"Census Tract 866.01, Orange County, California",2202,97,565,122,1637,141
6059086602,"Census Tract 866.02, Orange County, California",1640,96,493,103,1147,126
6059086701,"Census Tract 867.01, Orange County, California",2386,100,1586,166,800,155
6059086702,"Census Tract 867.02, Orange County, California",1809,80,751,135,1058,133
6059086801,"Census Tract 868.01, Orange County, California",902,51,823,65,79,55
6059086802,"Census Tract 868.02, Orange County, California",1550,44,754,96,796,94
6059086803,"Census Tract 868.03, Orange County, California",2515,133,1044,141,1471,156
6059086901,"Census Tract 869.01, Orange County, California",2752,120,450,113,2302,170
6059086902,"Census Tract 869.02, Orange County, California",1528,67,956,113,572,112
6059086903,"Census Tract 869.03, Orange County, California",1805,125,519,123,1286,148
6059087001,"Census Tract 870.01, Orange County, California",1587,66,697,98,890,100
6059087002,"Census Tract 870.02, Orange County, California",2257,80,962,177,1295,173
6059087101,"Census Tract 871.01, Orange County, California",1560,96,379,113,1181,121
6059087102,"Census Tract 871.02, Orange County, California",1598,102,273,73,1325,109
6059087103,"Census Tract 871.03, Orange County, California",2292,90,1326,166,966,160
6059087105,"Census Tract 871.05, Orange County, California",1391,74,597,104,794,129
6059087106,"Census Tract 871.06, Orange County, California",1266,70,566,113,700,131
6059087200,"Census Tract 872, Orange County, California",2388,132,987,143,1401,173
6059087300,"Census Tract 873, Orange County, California",2606,115,456,91,2150,141
6059087401,"Census Tract 874.01, Orange County, California",877,48,633,81,244,81
6059087403,"Census Tract 874.03, Orange County, California",707,74,337,76,370,83
6059087404,"Census Tract 874.04, Orange County, California",786,37,180,58,606,68
6059087405,"Census Tract 874.05, Orange County, California",1511,83,337,82,1174,100
6059087501,"Census Tract 875.01, Orange County, California",1366,71,644,100,722,112
6059087503,"Census Tract 875.03, Orange County, California",1781,65,683,82,1098,99
6059087504,"Census Tract 875.04, Orange County, California",1690,111,314,80,1376,130
6059087601,"Census Tract 876.01, Orange County, California",1376,103,404,70,972,111
6059087602,"Census Tract 876.02, Orange County, California",2074,104,1316,166,758,169
6059087701,"Census Tract 877.01, Orange County, California",1620,81,948,130,672,120
6059087703,"Census Tract 877.03, Orange County, California",1590,92,1082,129,508,133
6059087704,"Census Tract 877.04, Orange County, California",1294,86,935,103,359,106
6059087801,"Census Tract 878.01, Orange County, California",1664,113,936,130,728,156
6059087802,"Census Tract 878.02, Orange County, California",2125,156,1076,188,1049,194
6059087803,"Census Tract 878.03, Orange County, California",1383,68,236,66,1147,78
6059087805,"Census Tract 878.05, Orange County, California",1819,113,756,131,1063,137
6059087806,"Census Tract 878.06, Orange County, California",1555,77,540,110,1015,110
6059087901,"Census Tract 879.01, Orange County, California",987,100,532,73,455,93
6059087902,"Census Tract 879.02, Orange County, California",1421,68,774,110,647,103
6059088001,"Census Tract 880.01, Orange County, California",1192,64,936,100,256,96
6059088002,"Census Tract 880.02, Orange County, California",1016,72,690,99,326,102
6059088101,"Census Tract 881.01, Orange County, California",719,44,572,78,147,65
6059088104,"Census Tract 881.04, Orange County, California",1577,129,637,124,940,144
6059088105,"Census Tract 881.05, Orange County, California",1021,49,846,70,175,59
6059088106,"Census Tract 881.06, Orange County, California",1714,94,1084,130,630,119
6059088107,"Census Tract 881.07, Orange County, California",1533,76,748,129,785,119
6059088201,"Census Tract 882.01, Orange County, California",1070,46,763,99,307,100
6059088202,"Census Tract 882.02, Orange County, California",816,55,721,84,95,63
6059088203,"Census Tract 882.03, Orange County, California",1297,83,696,104,601,111
6059088301,"Census Tract 883.01, Orange County, California",1700,70,1063,110,637,116
6059088302,"Census Tract 883.02, Orange County, California",1648,96,1072,122,576,135
6059088401,"Census Tract 884.01, Orange County, California",1239,74,1148,99,91,68
6059088402,"Census Tract 884.02, Orange County, California",1295,80,537,79,758,105
6059088403,"Census Tract 884.03, Orange County, California",1649,85,1073,118,576,121
6059088501,"Census Tract 885.01, Orange County, California",1740,83,956,155,784,156
6059088502,"Census Tract 885.02, Orange County, California",1308,86,618,90,690,103
6059088601,"Census Tract 886.01, Orange County, California",1927,75,1091,113,836,111
6059088602,"Census Tract 886.02, Orange County, California",1353,74,577,107,776,120
6059088701,"Census Tract 887.01, Orange County, California",1866,74,675,139,1191,134
6059088702,"Census Tract 887.02, Orange County, California",1372,66,616,113,756,107
6059088801,"Census Tract 888.01, Orange County, California",2343,166,892,180,1451,213
6059088802,"Census Tract 888.02, Orange County, California",1375,61,801,148,574,145
6059088901,"Census Tract 889.01, Orange County, California",1606,67,1043,124,563,116
6059088902,"Census Tract 889.02, Orange County, California",1115,60,643,115,472,108
6059088903,"Census Tract 889.03, Orange County, California",1806,104,1086,167,720,158
6059088904,"Census Tract 889.04, Orange County, California",1379,59,862,105,517,104
6059088905,"Census Tract 889.05, Orange County, California",1228,84,892,114,336,139
6059089001,"Census Tract 890.01, Orange County, California",1593,103,1036,136,557,145
6059089003,"Census Tract 890.03, Orange County, California",849,35,436,97,413,98
6059089004,"Census Tract 890.04, Orange County, California",1799,79,1211,115,588,133
6059089102,"Census Tract 891.02, Orange County, California",1626,41,1038,129,588,122
6059089104,"Census Tract 891.04, Orange County, California",1364,61,432,85,932,100
6059089105,"Census Tract 891.05, Orange County, California",1160,71,365,110,795,114
6059089106,"Census Tract 891.06, Orange County, California",851,80,430,76,421,102
6059089107,"Census Tract 891.07, Orange County, California",1225,83,1044,98,181,61
6059099202,"Census Tract 992.02, Orange County, California",1860,65,1276,141,584,133
6059099203,"Census Tract 992.03, Orange County, California",1512,35,1093,107,419,106
6059099204,"Census Tract 992.04, Orange County, California",1319,80,876,136,443,103
6059099212,"Census Tract 992.12, Orange County, California",1741,44,734,127,1007,128
6059099214,"Census Tract 992.14, Orange County, California",1453,60,1219,92,234,85
6059099215,"Census Tract 992.15, Orange County, California",1913,50,1459,115,454,121
6059099216,"Census Tract 992.16, Orange County, California",1392,77,1046,104,346,110
6059099217,"Census Tract 992.17, Orange County, California",890,20,837,52,53,49
6059099220,"Census Tract 992.20, Orange County, California",2094,183,1296,144,798,168
6059099222,"Census Tract 992.22, Orange County, California",1376,83,1040,104,336,109
6059099223,"Census Tract 992.23, Orange County, California",1557,110,815,142,742,128
6059099224,"Census Tract 992.24, Orange County, California",1050,28,840,75,210,69
6059099225,"Census Tract 992.25, Orange County, California",1003,47,908,66,95,50
6059099226,"Census Tract 992.26, Orange County, California",1138,35,1051,64,87,57
6059099227,"Census Tract 992.27, Orange County, California",1913,98,1248,140,665,140
6059099229,"Census Tract 992.29, Orange County, California",2356,80,1127,142,1229,132
6059099230,"Census Tract 992.30, Orange County, California",1496,65,1185,116,311,100
6059099231,"Census Tract 992.31, Orange County, California",1746,59,1585,94,161,75
6059099232,"Census Tract 992.32, Orange County, California",1869,68,1754,82,115,47
6059099233,"Census Tract 992.33, Orange County, California",1085,32,954,54,131,47
6059099234,"Census Tract 992.34, Orange County, California",1166,35,940,67,226,61
6059099235,"Census Tract 992.35, Orange County, California",1854,110,949,119,905,147
6059099237,"Census Tract 992.37, Orange County, California",1216,69,1020,95,196,88
6059099238,"Census Tract 992.38, Orange County, California",1379,27,1297,43,82,42
6059099239,"Census Tract 992.39, Orange County, California",1317,63,1174,89,143,79
6059099240,"Census Tract 992.40, Orange County, California",2094,100,1202,120,892,146
6059099241,"Census Tract 992.41, Orange County, California",1638,42,597,105,1041,109
6059099242,"Census Tract 992.42, Orange County, California",1130,30,660,71,470,70
6059099243,"Census Tract 992.43, Orange County, California",1754,93,1425,124,329,109
6059099244,"Census Tract 992.44, Orange County, California",1908,73,1634,96,274,81
6059099245,"Census Tract 992.45, Orange County, California",1044,63,895,94,149,85
6059099246,"Census Tract 992.46, Orange County, California",1213,42,1099,67,114,63
6059099247,"Census Tract 992.47, Orange County, California",812,21,389,87,423,86
6059099248,"Census Tract 992.48, Orange County, California",1398,84,709,143,689,147
6059099249,"Census Tract 992.49, Orange County, California",854,43,283,81,571,85
6059099250,"Census Tract 992.50, Orange County, California",1096,43,582,93,514,110
6059099251,"Census Tract 992.51, Orange County, California",1971,119,518,88,1453,137
6059099305,"Census Tract 993.05, Orange County, California",3045,128,962,156,2083,188
6059099306,"Census Tract 993.06, Orange County, California",2473,167,1001,151,1472,189
6059099307,"Census Tract 993.07, Orange County, California",1344,110,895,111,449,112
6059099308,"Census Tract 993.08, Orange County, California",2139,62,2001,100,138,75
6059099309,"Census Tract 993.09, Orange County, California",1888,119,1206,123,682,132
6059099310,"Census Tract 993.10, Orange County, California",1918,177,823,146,1095,165
6059099311,"Census Tract 993.11, Orange County, California",1860,105,792,134,1068,140
6059099402,"Census Tract 994.02, Orange County, California",2112,76,499,103,1613,125
6059099404,"Census Tract 994.04, Orange County, California",1781,39,1140,104,641,114
6059099405,"Census Tract 994.05, Orange County, California",1576,84,1020,122,556,120
6059099406,"Census Tract 994.06, Orange County, California",1691,64,999,111,692,107
6059099407,"Census Tract 994.07, Orange County, California",948,38,707,59,241,58
6059099408,"Census Tract 994.08, Orange County, California",1668,35,1248,102,420,98
6059099410,"Census Tract 994.10, Orange County, California",1553,82,341,90,1212,105
6059099411,"Census Tract 994.11, Orange County, California",2167,120,564,110,1603,165
6059099412,"Census Tract 994.12, Orange County, California",1922,69,1064,110,858,111
6059099413,"Census Tract 994.13, Orange County, California",3306,139,1895,178,1411,208
6059099415,"Census Tract 994.15, Orange County, California",1932,76,1738,91,194,79
6059099416,"Census Tract 994.16, Orange County, California",2260,76,510,137,1750,152
6059099417,"Census Tract 994.17, Orange County, California",1788,128,937,147,851,153
6059099502,"Census Tract 995.02, Orange County, California",101,53,9,15,92,51
6059099504,"Census Tract 995.04, Orange County, California",977,36,886,67,91,53
6059099506,"Census Tract 995.06, Orange County, California",730,78,232,79,498,93
6059099508,"Census Tract 995.08, Orange County, California",2171,69,1238,127,933,128
6059099509,"Census Tract 995.09, Orange County, California",2671,148,2504,166,167,79
6059099510,"Census Tract 995.10, Orange County, California",3114,208,2883,220,231,95
6059099511,"Census Tract 995.11, Orange County, California",1746,122,577,110,1169,143
6059099512,"Census Tract 995.12, Orange County, California",1452,117,597,112,855,138
6059099513,"Census Tract 995.13, Orange County, California",1131,108,828,116,303,123
6059099514,"Census Tract 995.14, Orange County, California",2375,122,2291,127,84,56
6059099601,"Census Tract 996.01, Orange County, California",2022,103,968,145,1054,169
6059099602,"Census Tract 996.02, Orange County, California",1022,78,700,88,322,81
6059099603,"Census Tract 996.03, Orange County, California",2329,49,1804,128,525,127
6059099604,"Census Tract 996.04, Orange County, California",1189,57,1020,88,169,80
6059099605,"Census Tract 996.05, Orange County, California",1252,75,970,115,282,111
6059099701,"Census Tract 997.01, Orange County, California",1752,79,1005,134,747,126
6059099702,"Census Tract 997.02, Orange County, California",2514,149,1619,164,895,184
6059099703,"Census Tract 997.03, Orange County, California",1633,71,1091,116,542,120
6059099801,"Census Tract 998.01, Orange County, California",1503,52,662,121,841,119
6059099802,"Census Tract 998.02, Orange County, California",1431,83,308,83,1123,117
6059099803,"Census Tract 998.03, Orange County, California",1713,54,826,143,887,133
6059099902,"Census Tract 999.02, Orange County, California",1248,63,950,117,298,103
6059099903,"Census Tract 999.03, Orange County, California",1442,48,682,96,760,90
6059099904,"Census Tract 999.04, Orange County, California",2052,105,415,103,1637,135
6059099905,"Census Tract 999.05, Orange County, California",1228,91,529,82,699,116
6059099906,"Census Tract 999.06, Orange County, California",1634,60,1350,99,284,94
6059110001,"Census Tract 1100.01, Orange County, California",1477,46,1171,78,306,66
6059110003,"Census Tract 1100.03, Orange County, California",1145,66,774,83,371,83
6059110004,"Census Tract 1100.04, Orange County, California",1615,75,1554,87,61,45
6059110005,"Census Tract 1100.05, Orange County, California",1134,34,997,69,137,67
6059110006,"Census Tract 1100.06, Orange County, California",1230,81,1021,85,209,60
6059110007,"Census Tract 1100.07, Orange County, California",1910,65,1695,96,215,90
6059110008,"Census Tract 1100.08, Orange County, California",1985,62,1695,123,290,106
6059110010,"Census Tract 1100.10, Orange County, California",1363,40,1197,87,166,79
6059110011,"Census Tract 1100.11, Orange County, California",1059,34,953,57,106,48
6059110012,"Census Tract 1100.12, Orange County, California",1742,65,1658,76,84,52
6059110014,"Census Tract 1100.14, Orange County, California",1875,104,150,69,1725,118
6059110015,"Census Tract 1100.15, Orange County, California",1206,70,1079,87,127,65
6059110102,"Census Tract 1101.02, Orange County, California",1794,84,1480,115,314,83
6059110104,"Census Tract 1101.04, Orange County, California",2031,90,1132,160,899,138
6059110106,"Census Tract 1101.06, Orange County, California",1176,71,986,86,190,99
6059110108,"Census Tract 1101.08, Orange County, California",1006,75,659,100,347,96
6059110109,"Census Tract 1101.09, Orange County, California",1605,92,1077,110,528,102
6059110110,"Census Tract 1101.10, Orange County, California",1786,109,860,133,926,166
6059110111,"Census Tract 1101.11, Orange County, California",1711,100,1282,147,429,125
6059110113,"Census Tract 1101.13, Orange County, California",672,49,487,84,185,60
6059110114,"Census Tract 1101.14, Orange County, California",1461,47,1256,81,205,68
6059110115,"Census Tract 1101.15, Orange County, California",1144,84,878,82,266,82
6059110116,"Census Tract 1101.16, Orange County, California",1417,98,1088,107,329,98
6059110117,"Census Tract 1101.17, Orange County, California",1955,80,1168,126,787,131
6059110118,"Census Tract 1101.18, Orange County, California",719,26,680,45,39,42
6059110201,"Census Tract 1102.01, Orange County, California",2449,94,1199,187,1250,182
6059110202,"Census Tract 1102.02, Orange County, California",2220,132,673,135,1547,183
6059110203,"Census Tract 1102.03, Orange County, California",1713,56,1222,124,491,128
6059110301,"Census Tract 1103.01, Orange County, California",2045,135,1500,169,545,139
6059110302,"Census Tract 1103.02, Orange County, California",1612,73,1093,134,519,133
6059110303,"Census Tract 1103.03, Orange County, California",1425,73,1092,97,333,91
6059110304,"Census Tract 1103.04, Orange County, California",1313,59,1115,111,198,86
6059110401,"Census Tract 1104.01, Orange County, California",1381,69,1167,91,214,73
6059110402,"Census Tract 1104.02, Orange County, California",1293,82,695,90,598,96
6059110500,"Census Tract 1105, Orange County, California",2503,109,856,156,1647,178
6059110603,"Census Tract 1106.03, Orange County, California",2467,139,554,129,1913,174
6059110604,"Census Tract 1106.04, Orange County, California",2609,96,2105,151,504,139
6059110605,"Census Tract 1106.05, Orange County, California",2148,91,1392,156,756,182
6059110606,"Census Tract 1106.06, Orange County, California",1234,64,301,73,933,92
6059110607,"Census Tract 1106.07, Orange County, California",1099,78,536,72,563,98
6061020101,"Census Tract 201.01, Placer County, California",300,116,200,100,100,56
6061020102,"Census Tract 201.02, Placer County, California",413,165,278,133,135,105
6061020103,"Census Tract 201.03, Placer County, California",352,92,206,86,146,66
6061020104,"Census Tract 201.04, Placer County, California",525,113,403,118,122,75
6061020105,"Census Tract 201.05, Placer County, California",416,126,352,126,64,49
6061020106,"Census Tract 201.06, Placer County, California",694,116,520,111,174,82
6061020107,"Census Tract 201.07, Placer County, California",1044,157,388,152,656,181
6061020200,"Census Tract 202, Placer County, California",2368,168,2066,180,302,149
6061020300,"Census Tract 203, Placer County, California",2187,176,848,149,1339,192
6061020400,"Census Tract 204, Placer County, California",2317,191,1462,180,855,168
6061020500,"Census Tract 205, Placer County, California",2897,105,2611,125,286,94
6061020601,"Census Tract 206.01, Placer County, California",2659,120,2475,145,184,118
6061020602,"Census Tract 206.02, Placer County, California",2620,134,2299,175,321,121
6061020604,"Census Tract 206.04, Placer County, California",2085,99,1844,135,241,88
6061020605,"Census Tract 206.05, Placer County, California",1972,95,1785,109,187,87
6061020606,"Census Tract 206.06, Placer County, California",1450,70,1438,70,12,17
6061020702,"Census Tract 207.02, Placer County, California",2582,153,1332,149,1250,194
6061020703,"Census Tract 207.03, Placer County, California",2456,80,1684,191,772,171
6061020704,"Census Tract 207.04, Placer County, California",2802,128,1748,139,1054,155
6061020705,"Census Tract 207.05, Placer County, California",3443,161,2240,187,1203,153
6061020800,"Census Tract 208, Placer County, California",2973,160,1784,150,1189,201
6061020901,"Census Tract 209.01, Placer County, California",928,87,357,90,571,109
6061020902,"Census Tract 209.02, Placer County, California",3315,168,2350,205,965,206
6061021003,"Census Tract 210.03, Placer County, California",2113,144,1474,129,639,151
6061021004,"Census Tract 210.04, Placer County, California",4551,199,3060,190,1491,174
6061021005,"Census Tract 210.05, Placer County, California",4106,153,3400,203,706,183
6061021006,"Census Tract 210.06, Placer County, California",3038,98,2845,118,193,74
6061021007,"Census Tract 210.07, Placer County, California",5689,171,4129,237,1560,233
6061021008,"Census Tract 210.08, Placer County, California",3247,125,1597,171,1650,172
6061021103,"Census Tract 211.03, Placer County, California",1362,99,847,113,515,118
6061021104,"Census Tract 211.04, Placer County, California",3903,138,3507,192,396,139
6061021105,"Census Tract 211.05, Placer County, California",2838,172,1032,171,1806,226
6061021106,"Census Tract 211.06, Placer County, California",910,33,818,60,92,59
6061021107,"Census Tract 211.07, Placer County, California",4803,187,2980,187,1823,218
6061021108,"Census Tract 211.08, Placer County, California",1180,91,686,84,494,84
6061021109,"Census Tract 211.09, Placer County, California",1704,69,1358,123,346,104
6061021200,"Census Tract 212, Placer County, California",3327,220,2683,260,644,168
6061021301,"Census Tract 213.01, Placer County, California",4923,260,4179,284,744,176
6061021303,"Census Tract 213.03, Placer County, California",9981,260,8932,279,1049,198
6061021304,"Census Tract 213.04, Placer County, California",1978,101,1670,130,308,110
6061021401,"Census Tract 214.01, Placer County, California",992,113,763,101,229,92
6061021402,"Census Tract 214.02, Placer County, California",3611,175,2116,218,1495,228
6061021501,"Census Tract 215.01, Placer County, California",1992,119,1367,145,625,126
6061021502,"Census Tract 215.02, Placer County, California",1454,68,1170,93,284,85
6061021600,"Census Tract 216, Placer County, California",3072,155,1968,208,1104,186
6061021801,"Census Tract 218.01, Placer County, California",1751,61,1583,92,168,76
6061021802,"Census Tract 218.02, Placer County, California",2459,190,1756,167,703,162
6061021901,"Census Tract 219.01, Placer County, California",1146,90,917,124,229,109
6061021902,"Census Tract 219.02, Placer County, California",1701,106,1476,140,225,107
6061022001,"Census Tract 220.01, Placer County, California",2065,247,1562,221,503,168
6061022002,"Census Tract 220.02, Placer County, California",2352,134,1919,145,433,106
6063000100,"Census Tract 1, Plumas County, California",2567,252,1590,201,977,272
6063000201,"Census Tract 2.01, Plumas County, California",919,153,819,176,100,85
6063000202,"Census Tract 2.02, Plumas County, California",693,181,448,99,245,167
6063000300,"Census Tract 3, Plumas County, California",2437,211,1530,207,907,209
6063000400,"Census Tract 4, Plumas County, California",1203,140,741,133,462,137
6063000500,"Census Tract 5, Plumas County, California",2231,255,1394,172,837,245
6065010000,"Census Tract 100, Riverside County, California",1530,108,991,82,539,94
6065010100,"Census Tract 101, Riverside County, California",1788,109,624,49,1164,94
6065010200,"Census Tract 102, Riverside County, California",2091,127,1485,115,606,86
6065010300,"Census Tract 103, Riverside County, California",1602,96,1062,81,540,53
6065010400,"Census Tract 104, Riverside County, California",1895,121,1500,96,395,59
6065010500,"Census Tract 105, Riverside County, California",1257,77,887,64,370,56
6065010600,"Census Tract 106, Riverside County, California",1384,100,1229,94,155,39
6065010700,"Census Tract 107, Riverside County, California",893,86,615,61,278,47
6065010800,"Census Tract 108, Riverside County, California",1165,92,1016,91,149,33
6065010900,"Census Tract 109, Riverside County, California",1050,85,901,88,149,35
6065030100,"Census Tract 301, Riverside County, California",2550,163,1692,189,858,183
6065030200,"Census Tract 302, Riverside County, California",1794,121,867,104,927,157
6065030300,"Census Tract 303, Riverside County, California",1338,160,182,78,1156,165
6065030400,"Census Tract 304, Riverside County, California",1579,127,859,137,720,114
6065030501,"Census Tract 305.01, Riverside County, California",1337,67,768,115,569,114
6065030502,"Census Tract 305.02, Riverside County, California",467,58,272,73,195,62
6065030503,"Census Tract 305.03, Riverside County, California",983,109,209,76,774,117
6065030601,"Census Tract 306.01, Riverside County, California",1519,108,1430,108,89,61
6065030602,"Census Tract 306.02, Riverside County, California",1287,32,1142,70,145,66
6065030603,"Census Tract 306.03, Riverside County, California",1007,66,967,71,40,35
6065030700,"Census Tract 307, Riverside County, California",2218,57,1444,167,774,167
6065030800,"Census Tract 308, Riverside County, California",2334,113,1612,164,722,166
6065030900,"Census Tract 309, Riverside County, California",796,110,668,131,128,79
6065031001,"Census Tract 310.01, Riverside County, California",2038,101,1031,132,1007,123
6065031002,"Census Tract 310.02, Riverside County, California",1197,45,746,107,451,111
6065031100,"Census Tract 311, Riverside County, California",1592,117,963,134,629,126
6065031200,"Census Tract 312, Riverside County, California",2001,142,1658,162,343,127
6065031300,"Census Tract 313, Riverside County, California",604,86,495,90,109,73
6065031401,"Census Tract 314.01, Riverside County, California",2077,119,1004,154,1073,178
6065031402,"Census Tract 314.02, Riverside County, California",2124,169,823,139,1301,201
6065031501,"Census Tract 315.01, Riverside County, California",1857,178,824,151,1033,214
6065031502,"Census Tract 315.02, Riverside County, California",2591,98,1682,177,909,162
6065031600,"Census Tract 316, Riverside County, California",2856,153,1263,197,1593,223
6065031701,"Census Tract 317.01, Riverside County, California",827,40,585,91,242,88
6065031702,"Census Tract 317.02, Riverside County, California",709,38,532,80,177,77
6065031703,"Census Tract 317.03, Riverside County, California",1107,64,772,98,335,106
6065031704,"Census Tract 317.04, Riverside County, California",1816,52,937,133,879,139
6065040100,"Census Tract 401, Riverside County, California",1996,138,1509,192,487,162
6065040201,"Census Tract 402.01, Riverside County, California",1619,84,1127,123,492,128
6065040202,"Census Tract 402.02, Riverside County, California",885,59,651,87,234,85
6065040203,"Census Tract 402.03, Riverside County, California",1087,86,461,122,626,155
6065040204,"Census Tract 402.04, Riverside County, California",949,60,487,97,462,116
6065040301,"Census Tract 403.01, Riverside County, California",2130,128,1445,212,685,180
6065040302,"Census Tract 403.02, Riverside County, California",2085,67,1913,95,172,84
6065040303,"Census Tract 403.03, Riverside County, California",767,69,575,81,192,86
6065040401,"Census Tract 404.01, Riverside County, California",2497,111,2097,216,400,196
6065040402,"Census Tract 404.02, Riverside County, California",1046,49,803,101,243,92
6065040403,"Census Tract 404.03, Riverside County, California",1218,90,859,129,359,111
6065040501,"Census Tract 405.01, Riverside County, California",1779,59,1434,137,345,138
6065040502,"Census Tract 405.02, Riverside County, California",1342,91,813,136,529,121
6065040503,"Census Tract 405.03, Riverside County, California",1781,72,520,90,1261,105
6065040602,"Census Tract 406.02, Riverside County, California",10690,356,9034,355,1656,335
6065040603,"Census Tract 406.03, Riverside County, California",554,79,410,111,144,83
6065040604,"Census Tract 406.04, Riverside County, California",1412,70,1333,84,79,63
6065040605,"Census Tract 406.05, Riverside County, California",704,59,400,112,304,110
6065040606,"Census Tract 406.06, Riverside County, California",783,76,597,97,186,91
6065040701,"Census Tract 407.01, Riverside County, California",719,45,689,56,30,45
6065040702,"Census Tract 407.02, Riverside County, California",864,99,654,121,210,92
6065040703,"Census Tract 407.03, Riverside County, California",874,86,683,112,191,128
6065040803,"Census Tract 408.03, Riverside County, California",2815,148,2272,171,543,156
6065040804,"Census Tract 408.04, Riverside County, California",1038,94,972,100,66,45
6065040805,"Census Tract 408.05, Riverside County, California",149,75,149,75,0,132
6065040806,"Census Tract 408.06, Riverside County, California",824,25,729,65,95,61
6065040807,"Census Tract 408.07, Riverside County, California",949,88,862,109,87,68
6065040808,"Census Tract 408.08, Riverside County, California",2221,72,1005,132,1216,129
6065040809,"Census Tract 408.09, Riverside County, California",910,57,755,92,155,95
6065040810,"Census Tract 408.10, Riverside County, California",3708,148,2541,168,1167,199
6065040811,"Census Tract 408.11, Riverside County, California",2631,123,1581,174,1050,191
6065040901,"Census Tract 409.01, Riverside County, California",1864,135,909,118,955,153
6065040902,"Census Tract 409.02, Riverside County, California",1462,91,1260,131,202,94
6065040903,"Census Tract 409.03, Riverside County, California",762,58,500,92,262,105
6065040904,"Census Tract 409.04, Riverside County, California",847,91,608,123,239,111
6065041001,"Census Tract 410.01, Riverside County, California",832,45,364,78,468,91
6065041002,"Census Tract 410.02, Riverside County, California",807,25,741,53,66,50
6065041003,"Census Tract 410.03, Riverside County, California",670,45,558,67,112,61
6065041004,"Census Tract 410.04, Riverside County, California",1377,63,535,103,842,110
6065041100,"Census Tract 411, Riverside County, California",1963,90,856,108,1107,123
6065041201,"Census Tract 412.01, Riverside County, California",899,83,737,91,162,87
6065041202,"Census Tract 412.02, Riverside County, California",1021,33,820,96,201,102
6065041203,"Census Tract 412.03, Riverside County, California",980,58,476,105,504,103
6065041300,"Census Tract 413, Riverside County, California",1779,129,1079,132,700,135
6065041403,"Census Tract 414.03, Riverside County, California",1019,72,705,91,314,83
6065041404,"Census Tract 414.04, Riverside County, California",939,43,859,52,80,55
6065041405,"Census Tract 414.05, Riverside County, California",1204,71,1038,90,166,82
6065041406,"Census Tract 414.06, Riverside County, California",1801,122,717,90,1084,144
6065041407,"Census Tract 414.07, Riverside County, California",1699,80,698,111,1001,128
6065041408,"Census Tract 414.08, Riverside County, California",1384,102,440,86,944,114
6065041409,"Census Tract 414.09, Riverside County, California",3730,147,3456,179,274,173
6065041410,"Census Tract 414.10, Riverside County, California",610,81,270,77,340,99
6065041411,"Census Tract 414.11, Riverside County, California",796,45,631,98,165,81
6065041412,"Census Tract 414.12, Riverside County, California",1424,75,1193,133,231,108
6065041500,"Census Tract 415, Riverside County, California",400,71,229,78,171,78
6065041600,"Census Tract 416, Riverside County, California",1556,130,526,141,1030,164
6065041702,"Census Tract 417.02, Riverside County, California",1263,34,994,82,269,84
6065041703,"Census Tract 417.03, Riverside County, California",1523,78,329,88,1194,111
6065041704,"Census Tract 417.04, Riverside County, California",786,87,379,73,407,91
6065041803,"Census Tract 418.03, Riverside County, California",1612,70,1482,83,130,67
6065041804,"Census Tract 418.04, Riverside County, California",1141,28,1090,53,51,48
6065041805,"Census Tract 418.05, Riverside County, California",1840,76,1071,132,769,140
6065041806,"Census Tract 418.06, Riverside County, California",1150,45,1031,83,119,71
6065041807,"Census Tract 418.07, Riverside County, California",630,53,555,76,75,61
6065041808,"Census Tract 418.08, Riverside County, California",1697,64,1503,93,194,73
6065041809,"Census Tract 418.09, Riverside County, California",1934,95,1138,128,796,153
6065041810,"Census Tract 418.10, Riverside County, California",1476,63,1454,69,22,26
6065041811,"Census Tract 418.11, Riverside County, California",3037,154,2752,191,285,125
6065041812,"Census Tract 418.12, Riverside County, California",967,54,932,62,35,29
6065041813,"Census Tract 418.13, Riverside County, California",1872,118,981,133,891,159
6065041903,"Census Tract 419.03, Riverside County, California",3542,140,2746,182,796,208
6065041904,"Census Tract 419.04, Riverside County, California",1390,73,1290,86,100,65
6065041905,"Census Tract 419.05, Riverside County, California",858,49,319,66,539,74
6065041906,"Census Tract 419.06, Riverside County, California",1904,71,1151,123,753,127
6065041907,"Census Tract 419.07, Riverside County, California",1622,68,1518,79,104,57
6065041908,"Census Tract 419.08, Riverside County, California",4687,204,4020,280,667,200
6065041909,"Census Tract 419.09, Riverside County, California",1371,80,1074,109,297,106
6065042003,"Census Tract 420.03, Riverside County, California",1377,66,1349,72,28,33
6065042004,"Census Tract 420.04, Riverside County, California",1017,31,947,67,70,55
6065042005,"Census Tract 420.05, Riverside County, California",1245,71,1113,101,132,111
6065042006,"Census Tract 420.06, Riverside County, California",6813,179,5455,244,1358,230
6065042007,"Census Tract 420.07, Riverside County, California",1306,102,1186,103,120,63
6065042008,"Census Tract 420.08, Riverside County, California",1912,98,1776,107,136,73
6065042009,"Census Tract 420.09, Riverside County, California",1585,120,1276,146,309,135
6065042010,"Census Tract 420.10, Riverside County, California",1369,76,1172,96,197,85
6065042100,"Census Tract 421, Riverside County, California",589,67,174,55,415,80
6065042202,"Census Tract 422.02, Riverside County, California",263,79,0,132,263,79
6065042205,"Census Tract 422.05, Riverside County, California",3686,176,2342,232,1344,233
6065042206,"Census Tract 422.06, Riverside County, California",2247,168,743,136,1504,182
6065042207,"Census Tract 422.07, Riverside County, California",1015,96,797,92,218,80
6065042208,"Census Tract 422.08, Riverside County, California",921,25,796,60,125,54
6065042209,"Census Tract 422.09, Riverside County, California",1429,113,476,121,953,138
6065042210,"Census Tract 422.10, Riverside County, California",1607,131,189,57,1418,145
6065042211,"Census Tract 422.11, Riverside County, California",1190,115,22,35,1168,114
6065042212,"Census Tract 422.12, Riverside County, California",1960,142,1320,188,640,147
6065042213,"Census Tract 422.13, Riverside County, California",1593,52,904,110,689,109
6065042214,"Census Tract 422.14, Riverside County, California",1814,110,1570,105,244,105
6065042300,"Census Tract 423, Riverside County, California",1953,108,1203,139,750,138
6065042401,"Census Tract 424.01, Riverside County, California",577,56,538,47,39,44
6065042402,"Census Tract 424.02, Riverside County, California",1283,72,1082,105,201,89
6065042403,"Census Tract 424.03, Riverside County, California",1132,80,1009,87,123,63
6065042404,"Census Tract 424.04, Riverside County, California",546,52,391,84,155,93
6065042405,"Census Tract 424.05, Riverside County, California",1756,130,255,93,1501,155
6065042406,"Census Tract 424.06, Riverside County, California",1236,85,1015,120,221,102
6065042407,"Census Tract 424.07, Riverside County, California",832,89,676,111,156,87
6065042408,"Census Tract 424.08, Riverside County, California",793,87,523,106,270,101
6065042409,"Census Tract 424.09, Riverside County, California",956,82,745,137,211,113
6065042410,"Census Tract 424.10, Riverside County, California",1379,77,1248,115,131,77
6065042411,"Census Tract 424.11, Riverside County, California",801,36,735,77,66,66
6065042412,"Census Tract 424.12, Riverside County, California",1419,97,1248,135,171,86
6065042504,"Census Tract 425.04, Riverside County, California",839,55,259,65,580,80
6065042505,"Census Tract 425.05, Riverside County, California",887,87,337,86,550,108
6065042506,"Census Tract 425.06, Riverside County, California",2220,145,1156,156,1064,172
6065042507,"Census Tract 425.07, Riverside County, California",1124,79,935,96,189,89
6065042508,"Census Tract 425.08, Riverside County, California",1205,100,871,123,334,105
6065042509,"Census Tract 425.09, Riverside County, California",779,72,651,85,128,73
6065042510,"Census Tract 425.10, Riverside County, California",1143,100,915,97,228,108
6065042511,"Census Tract 425.11, Riverside County, California",919,80,604,98,315,101
6065042512,"Census Tract 425.12, Riverside County, California",884,74,420,77,464,96
6065042513,"Census Tract 425.13, Riverside County, California",827,61,602,104,225,89
6065042514,"Census Tract 425.14, Riverside County, California",920,48,351,73,569,82
6065042515,"Census Tract 425.15, Riverside County, California",1032,88,190,70,842,106
6065042516,"Census Tract 425.16, Riverside County, California",874,72,574,118,300,111
6065042517,"Census Tract 425.17, Riverside County, California",864,55,647,76,217,87
6065042518,"Census Tract 425.18, Riverside County, California",835,29,600,82,235,83
6065042519,"Census Tract 425.19, Riverside County, California",521,53,143,51,378,70
6065042520,"Census Tract 425.20, Riverside County, California",1172,59,583,115,589,95
6065042521,"Census Tract 425.21, Riverside County, California",1210,75,945,122,265,91
6065042522,"Census Tract 425.22, Riverside County, California",1119,37,1010,85,109,84
6065042523,"Census Tract 425.23, Riverside County, California",439,40,418,43,21,25
6065042602,"Census Tract 426.02, Riverside County, California",3173,191,2450,191,723,176
6065042603,"Census Tract 426.03, Riverside County, California",3863,173,2669,243,1194,217
6065042604,"Census Tract 426.04, Riverside County, California",2013,130,1673,161,340,115
6065042605,"Census Tract 426.05, Riverside County, California",8897,309,6976,384,1921,299
6065042606,"Census Tract 426.06, Riverside County, California",2186,145,1506,144,680,129
6065042706,"Census Tract 427.06, Riverside County, California",1684,112,1110,152,574,129
6065042708,"Census Tract 427.08, Riverside County, California",1394,87,1089,138,305,100
6065042709,"Census Tract 427.09, Riverside County, California",2064,90,1803,119,261,99
6065042710,"Census Tract 427.10, Riverside County, California",2639,126,2293,153,346,115
6065042711,"Census Tract 427.11, Riverside County, California",2713,129,2160,160,553,142
6065042712,"Census Tract 427.12, Riverside County, California",5303,246,4391,286,912,215
6065042713,"Census Tract 427.13, Riverside County, California",2500,145,2037,189,463,147
6065042714,"Census Tract 427.14, Riverside County, California",1333,126,1117,134,216,91
6065042715,"Census Tract 427.15, Riverside County, California",2978,188,2296,191,682,159
6065042716,"Census Tract 427.16, Riverside County, California",1871,162,1461,234,410,196
6065042717,"Census Tract 427.17, Riverside County, California",1381,119,1102,150,279,107
6065042718,"Census Tract 427.18, Riverside County, California",2791,147,2276,167,515,156
6065042719,"Census Tract 427.19, Riverside County, California",1297,122,856,131,441,101
6065042720,"Census Tract 427.20, Riverside County, California",1105,106,826,108,279,117
6065042721,"Census Tract 427.21, Riverside County, California",2382,180,2026,195,356,142
6065042722,"Census Tract 427.22, Riverside County, California",5870,224,4651,246,1219,250
6065042723,"Census Tract 427.23, Riverside County, California",1773,140,1353,161,420,140
6065042800,"Census Tract 428, Riverside County, California",2266,157,838,137,1428,164
6065042901,"Census Tract 429.01, Riverside County, California",1537,111,1082,144,455,122
6065042902,"Census Tract 429.02, Riverside County, California",1279,106,647,134,632,146
6065042903,"Census Tract 429.03, Riverside County, California",1181,96,929,126,252,112
6065042904,"Census Tract 429.04, Riverside County, California",1984,114,1264,165,720,165
6065043001,"Census Tract 430.01, Riverside County, California",1604,117,852,123,752,139
6065043002,"Census Tract 430.02, Riverside County, California",3413,163,3042,202,371,177
6065043003,"Census Tract 430.03, Riverside County, California",2007,130,939,147,1068,167
6065043004,"Census Tract 430.04, Riverside County, California",3029,169,2657,201,372,184
6065043005,"Census Tract 430.05, Riverside County, California",1388,165,908,175,480,132
6065043006,"Census Tract 430.06, Riverside County, California",1300,114,629,113,671,127
6065043203,"Census Tract 432.03, Riverside County, California",11294,333,9955,352,1339,289
6065043206,"Census Tract 432.06, Riverside County, California",2329,138,1215,165,1114,172
6065043207,"Census Tract 432.07, Riverside County, California",5356,200,4076,233,1280,213
6065043208,"Census Tract 432.08, Riverside County, California",4647,217,4027,279,620,181
6065043209,"Census Tract 432.09, Riverside County, California",2780,150,2006,220,774,158
6065043210,"Census Tract 432.10, Riverside County, California",4736,187,3163,277,1573,268
6065043211,"Census Tract 432.11, Riverside County, California",1657,81,1479,104,178,95
6065043212,"Census Tract 432.12, Riverside County, California",3200,149,2335,188,865,186
6065043213,"Census Tract 432.13, Riverside County, California",5322,254,4361,324,961,220
6065043214,"Census Tract 432.14, Riverside County, California",8651,287,7173,320,1478,286
6065043215,"Census Tract 432.15, Riverside County, California",1126,91,569,87,557,89
6065043216,"Census Tract 432.16, Riverside County, California",2534,146,849,146,1685,205
6065043217,"Census Tract 432.17, Riverside County, California",1160,96,709,125,451,135
6065043218,"Census Tract 432.18, Riverside County, California",1621,90,1381,134,240,112
6065043219,"Census Tract 432.19, Riverside County, California",3569,187,2695,200,874,174
6065043220,"Census Tract 432.20, Riverside County, California",1561,101,526,88,1035,112
6065043221,"Census Tract 432.21, Riverside County, California",5712,157,4635,264,1077,240
6065043222,"Census Tract 432.22, Riverside County, California",1234,58,1169,79,65,47
6065043223,"Census Tract 432.23, Riverside County, California",2809,155,2174,169,635,188
6065043224,"Census Tract 432.24, Riverside County, California",3853,189,3602,183,251,83
6065043225,"Census Tract 432.25, Riverside County, California",2675,168,2145,197,530,177
6065043304,"Census Tract 433.04, Riverside County, California",2182,138,1986,161,196,103
6065043305,"Census Tract 433.05, Riverside County, California",3089,215,2584,228,505,134
6065043306,"Census Tract 433.06, Riverside County, California",1576,95,1265,127,311,107
6065043307,"Census Tract 433.07, Riverside County, California",2241,150,1248,146,993,175
6065043308,"Census Tract 433.08, Riverside County, California",945,101,351,94,594,113
6065043309,"Census Tract 433.09, Riverside County, California",934,69,384,84,550,101
6065043310,"Census Tract 433.10, Riverside County, California",911,91,396,74,515,110
6065043311,"Census Tract 433.11, Riverside County, California",553,73,412,63,141,72
6065043312,"Census Tract 433.12, Riverside County, California",1163,92,843,129,320,102
6065043313,"Census Tract 433.13, Riverside County, California",1016,69,616,85,400,93
6065043314,"Census Tract 433.14, Riverside County, California",1113,79,876,109,237,79
6065043315,"Census Tract 433.15, Riverside County, California",646,78,497,97,149,70
6065043401,"Census Tract 434.01, Riverside County, California",1829,151,786,156,1043,210
6065043403,"Census Tract 434.03, Riverside County, California",979,69,446,88,533,105
6065043404,"Census Tract 434.04, Riverside County, California",1301,88,814,117,487,121
6065043405,"Census Tract 434.05, Riverside County, California",1546,171,922,124,624,141
6065043503,"Census Tract 435.03, Riverside County, California",2118,186,1018,193,1100,167
6065043504,"Census Tract 435.04, Riverside County, California",2180,213,1675,215,505,154
6065043505,"Census Tract 435.05, Riverside County, California",1562,83,799,118,763,105
6065043506,"Census Tract 435.06, Riverside County, California",1899,97,1627,112,272,100
6065043507,"Census Tract 435.07, Riverside County, California",2364,179,751,157,1613,214
6065043508,"Census Tract 435.08, Riverside County, California",2394,183,1778,173,616,182
6065043509,"Census Tract 435.09, Riverside County, California",1778,123,1308,158,470,145
6065043510,"Census Tract 435.10, Riverside County, California",3156,236,2522,269,634,180
6065043511,"Census Tract 435.11, Riverside County, California",2393,157,1917,193,476,157
6065043600,"Census Tract 436, Riverside County, California",2433,163,1059,175,1374,203
6065043701,"Census Tract 437.01, Riverside County, California",1389,134,1138,117,251,105
6065043702,"Census Tract 437.02, Riverside County, California",1702,93,1310,133,392,118
6065043703,"Census Tract 437.03, Riverside County, California",946,59,749,88,197,87
6065043704,"Census Tract 437.04, Riverside County, California",1336,79,1130,117,206,102
6065043802,"Census Tract 438.02, Riverside County, California",1887,161,1490,168,397,116
6065043805,"Census Tract 438.05, Riverside County, California",4628,271,3786,322,842,225
6065043806,"Census Tract 438.06, Riverside County, California",4294,243,3694,270,600,215
6065043807,"Census Tract 438.07, Riverside County, California",1827,120,1440,148,387,132
6065043808,"Census Tract 438.08, Riverside County, California",3045,173,2592,193,453,135
6065043809,"Census Tract 438.09, Riverside County, California",1333,72,1246,110,87,76
6065043900,"Census Tract 439, Riverside County, California",1990,139,1057,173,933,192
6065044000,"Census Tract 440, Riverside County, California",592,99,180,64,412,95
6065044101,"Census Tract 441.01, Riverside County, California",1083,75,417,116,666,127
6065044102,"Census Tract 441.02, Riverside County, California",951,101,593,113,358,115
6065044103,"Census Tract 441.03, Riverside County, California",2400,152,1819,210,581,195
6065044104,"Census Tract 441.04, Riverside County, California",954,95,727,150,227,152
6065044200,"Census Tract 442, Riverside County, California",1613,126,778,117,835,155
6065044300,"Census Tract 443, Riverside County, California",1384,96,892,125,492,132
6065044401,"Census Tract 444.01, Riverside County, California",1079,183,698,144,381,115
6065044402,"Census Tract 444.02, Riverside County, California",1988,214,1623,206,365,133
6065044403,"Census Tract 444.03, Riverside County, California",1257,127,975,130,282,114
6065044503,"Census Tract 445.03, Riverside County, California",2090,248,1587,215,503,181
6065044504,"Census Tract 445.04, Riverside County, California",2705,269,2128,273,577,190
6065044505,"Census Tract 445.05, Riverside County, California",2301,176,1925,175,376,172
6065044506,"Census Tract 445.06, Riverside County, California",2874,237,1983,266,891,215
6065044507,"Census Tract 445.07, Riverside County, California",1633,149,954,123,679,148
6065044508,"Census Tract 445.08, Riverside County, California",2610,210,1981,180,629,167
6065044509,"Census Tract 445.09, Riverside County, California",1278,148,466,112,812,132
6065044510,"Census Tract 445.10, Riverside County, California",1534,149,621,177,913,191
6065044601,"Census Tract 446.01, Riverside County, California",3111,313,1375,196,1736,318
6065044602,"Census Tract 446.02, Riverside County, California",1811,197,1061,139,750,162
6065044604,"Census Tract 446.04, Riverside County, California",1892,188,1491,206,401,153
6065044701,"Census Tract 447.01, Riverside County, California",1752,168,695,127,1057,157
6065044702,"Census Tract 447.02, Riverside County, California",674,91,448,106,226,109
6065044804,"Census Tract 448.04, Riverside County, California",1080,100,645,90,435,97
6065044805,"Census Tract 448.05, Riverside County, California",944,146,620,126,324,119
6065044806,"Census Tract 448.06, Riverside County, California",1259,166,675,127,584,143
6065044807,"Census Tract 448.07, Riverside County, California",1016,117,461,100,555,115
6065044808,"Census Tract 448.08, Riverside County, California",1365,148,1021,120,344,142
6065044904,"Census Tract 449.04, Riverside County, California",1245,93,1063,121,182,104
6065044905,"Census Tract 449.05, Riverside County, California",2502,167,1877,197,625,164
6065044906,"Census Tract 449.06, Riverside County, California",2376,174,1828,252,548,209
6065044907,"Census Tract 449.07, Riverside County, California",1252,111,565,136,687,155
6065044909,"Census Tract 449.09, Riverside County, California",3955,241,3528,246,427,132
6065044910,"Census Tract 449.10, Riverside County, California",1755,174,1294,153,461,132
6065044911,"Census Tract 449.11, Riverside County, California",2538,218,1334,185,1204,236
6065044912,"Census Tract 449.12, Riverside County, California",3543,288,2872,281,671,185
6065044913,"Census Tract 449.13, Riverside County, California",3350,290,1984,234,1366,248
6065044914,"Census Tract 449.14, Riverside County, California",5533,286,4984,280,549,179
6065044915,"Census Tract 449.15, Riverside County, California",1900,121,569,115,1331,173
6065044916,"Census Tract 449.16, Riverside County, California",1575,132,890,120,685,137
6065045000,"Census Tract 450, Riverside County, California",1525,173,987,124,538,165
6065045103,"Census Tract 451.03, Riverside County, California",2105,221,1591,204,514,154
6065045105,"Census Tract 451.05, Riverside County, California",2188,211,1990,207,198,85
6065045106,"Census Tract 451.06, Riverside County, California",3053,274,1618,201,1435,241
6065045107,"Census Tract 451.07, Riverside County, California",2467,192,1599,207,868,191
6065045108,"Census Tract 451.08, Riverside County, California",2265,189,906,141,1359,195
6065045109,"Census Tract 451.09, Riverside County, California",1646,145,1204,181,442,129
6065045110,"Census Tract 451.10, Riverside County, California",2040,141,1524,167,516,140
6065045111,"Census Tract 451.11, Riverside County, California",4485,340,3072,285,1413,256
6065045112,"Census Tract 451.12, Riverside County, California",1928,147,1678,160,250,112
6065045113,"Census Tract 451.13, Riverside County, California",2267,245,1902,196,365,177
6065045203,"Census Tract 452.03, Riverside County, California",4911,336,3555,291,1356,295
6065045204,"Census Tract 452.04, Riverside County, California",3061,220,2601,249,460,177
6065045205,"Census Tract 452.05, Riverside County, California",5328,283,4124,335,1204,290
6065045206,"Census Tract 452.06, Riverside County, California",7465,379,5556,360,1909,358
6065045207,"Census Tract 452.07, Riverside County, California",1708,131,764,135,944,176
6065045208,"Census Tract 452.08, Riverside County, California",2149,149,1773,162,376,133
6065045209,"Census Tract 452.09, Riverside County, California",1936,81,892,135,1044,131
6065045301,"Census Tract 453.01, Riverside County, California",2923,221,1928,215,995,225
6065045302,"Census Tract 453.02, Riverside County, California",1295,65,944,114,351,114
6065045400,"Census Tract 454, Riverside County, California",2657,160,1199,158,1458,168
6065045501,"Census Tract 455.01, Riverside County, California",1676,104,649,101,1027,130
6065045502,"Census Tract 455.02, Riverside County, California",1305,122,415,97,890,128
6065045603,"Census Tract 456.03, Riverside County, California",4176,320,3117,287,1059,230
6065045604,"Census Tract 456.04, Riverside County, California",2443,173,1302,218,1141,232
6065045605,"Census Tract 456.05, Riverside County, California",2059,142,1185,147,874,147
6065045702,"Census Tract 457.02, Riverside County, California",2871,179,2296,213,575,156
6065045703,"Census Tract 457.03, Riverside County, California",1089,84,869,95,220,91
6065045704,"Census Tract 457.04, Riverside County, California",748,74,450,85,298,79
6065045705,"Census Tract 457.05, Riverside County, California",1584,126,345,98,1239,147
6065045706,"Census Tract 457.06, Riverside County, California",1276,78,729,119,547,104
6065045800,"Census Tract 458, Riverside County, California",701,109,464,95,237,91
6065045900,"Census Tract 459, Riverside County, California",712,70,419,84,293,93
6065046000,"Census Tract 460, Riverside County, California",593,126,308,75,285,109
6065046101,"Census Tract 461.01, Riverside County, California",1300,129,741,143,559,145
6065046102,"Census Tract 461.02, Riverside County, California",640,131,104,60,536,125
6065046103,"Census Tract 461.03, Riverside County, California",1008,103,782,125,226,88
6065046200,"Census Tract 462, Riverside County, California",1194,164,546,140,648,170
6065046401,"Census Tract 464.01, Riverside County, California",1039,83,702,124,337,118
6065046402,"Census Tract 464.02, Riverside County, California",1498,115,807,132,691,145
6065046403,"Census Tract 464.03, Riverside County, California",1929,147,1630,178,299,123
6065046404,"Census Tract 464.04, Riverside County, California",1372,141,1095,160,277,108
6065046405,"Census Tract 464.05, Riverside County, California",1201,86,905,99,296,100
6065940100,"Census Tract 9401, Riverside County, California",86,46,86,46,0,132
6065940300,"Census Tract 9403, Riverside County, California",0,132,0,132,0,132
6067000100,"Census Tract 1, Sacramento County, California",1663,83,1184,108,479,97
6067000200,"Census Tract 2, Sacramento County, California",1860,62,1323,120,537,114
6067000300,"Census Tract 3, Sacramento County, California",1521,79,1131,110,390,120
6067000400,"Census Tract 4, Sacramento County, California",2396,99,548,144,1848,170
6067000500,"Census Tract 5, Sacramento County, California",1918,97,126,57,1792,112
6067000600,"Census Tract 6, Sacramento County, California",598,41,19,21,579,39
6067000700,"Census Tract 7, Sacramento County, California",444,66,25,30,419,72
6067000800,"Census Tract 8, Sacramento County, California",793,139,72,37,721,132
6067000900,"Census Tract 9, Sacramento County, California",134,42,105,45,29,22
6067001000,"Census Tract 10, Sacramento County, California",487,96,8,14,479,95
6067001100,"Census Tract 11, Sacramento County, California",652,75,30,28,622,73
6067001200,"Census Tract 12, Sacramento County, California",2566,149,100,71,2466,159
6067001300,"Census Tract 13, Sacramento County, California",1925,144,149,73,1776,150
6067001400,"Census Tract 14, Sacramento County, California",1746,90,204,67,1542,112
6067001500,"Census Tract 15, Sacramento County, California",2290,151,1172,158,1118,161
6067001600,"Census Tract 16, Sacramento County, California",2529,123,1670,177,859,189
6067001700,"Census Tract 17, Sacramento County, California",2622,167,1346,155,1276,198
6067001800,"Census Tract 18, Sacramento County, California",1986,130,842,151,1144,175
6067001900,"Census Tract 19, Sacramento County, California",1617,118,194,87,1423,142
6067002000,"Census Tract 20, Sacramento County, California",1280,104,215,94,1065,138
6067002100,"Census Tract 21, Sacramento County, California",1094,124,281,106,813,135
6067002200,"Census Tract 22, Sacramento County, California",1743,83,702,108,1041,132
6067002300,"Census Tract 23, Sacramento County, California",1677,74,1208,96,469,104
6067002400,"Census Tract 24, Sacramento County, California",2017,113,1506,113,511,127
6067002500,"Census Tract 25, Sacramento County, California",757,39,716,49,41,40
6067002600,"Census Tract 26, Sacramento County, California",1248,82,672,103,576,104
6067002700,"Census Tract 27, Sacramento County, California",1409,135,417,99,992,133
6067002800,"Census Tract 28, Sacramento County, California",846,134,439,114,407,132
6067002900,"Census Tract 29, Sacramento County, California",2212,106,1576,190,636,192
6067003000,"Census Tract 30, Sacramento County, California",2822,135,1854,206,968,224
6067003101,"Census Tract 31.01, Sacramento County, California",1051,116,738,123,313,102
6067003102,"Census Tract 31.02, Sacramento County, California",1044,122,712,122,332,135
6067003201,"Census Tract 32.01, Sacramento County, California",2265,102,1111,191,1154,206
6067003202,"Census Tract 32.02, Sacramento County, California",1745,78,971,113,774,111
6067003300,"Census Tract 33, Sacramento County, California",1831,92,1545,106,286,81
6067003400,"Census Tract 34, Sacramento County, California",1809,124,1420,144,389,101
6067003501,"Census Tract 35.01, Sacramento County, California",1283,70,580,103,703,112
6067003502,"Census Tract 35.02, Sacramento County, California",1372,57,889,108,483,108
6067003600,"Census Tract 36, Sacramento County, California",939,69,494,109,445,114
6067003700,"Census Tract 37, Sacramento County, California",1198,101,561,125,637,135
6067003800,"Census Tract 38, Sacramento County, California",1652,108,1299,130,353,123
6067003900,"Census Tract 39, Sacramento County, California",1559,127,1126,121,433,111
6067004001,"Census Tract 40.01, Sacramento County, California",2788,164,1534,190,1254,226
6067004004,"Census Tract 40.04, Sacramento County, California",2794,92,2013,177,781,169
6067004005,"Census Tract 40.05, Sacramento County, California",1860,130,950,144,910,155
6067004006,"Census Tract 40.06, Sacramento County, California",2132,167,1044,157,1088,150
6067004008,"Census Tract 40.08, Sacramento County, California",1607,66,1181,110,426,121
6067004009,"Census Tract 40.09, Sacramento County, California",2280,130,1182,114,1098,167
6067004010,"Census Tract 40.10, Sacramento County, California",2279,117,920,132,1359,134
6067004011,"Census Tract 40.11, Sacramento County, California",1257,63,717,65,540,76
6067004012,"Census Tract 40.12, Sacramento County, California",1458,72,913,84,545,84
6067004100,"Census Tract 41, Sacramento County, California",1598,88,634,100,964,118
6067004201,"Census Tract 42.01, Sacramento County, California",1557,98,1112,135,445,114
6067004202,"Census Tract 42.02, Sacramento County, California",1600,96,669,101,931,122
6067004203,"Census Tract 42.03, Sacramento County, California",1536,59,706,97,830,99
6067004300,"Census Tract 43, Sacramento County, California",2138,161,1281,193,857,193
6067004401,"Census Tract 44.01, Sacramento County, California",1295,104,641,92,654,128
6067004402,"Census Tract 44.02, Sacramento County, California",1183,96,555,110,628,127
6067004500,"Census Tract 45, Sacramento County, California",2605,138,822,128,1783,158
6067004601,"Census Tract 46.01, Sacramento County, California",2347,156,936,224,1411,209
6067004602,"Census Tract 46.02, Sacramento County, California",1402,115,541,125,861,132
6067004700,"Census Tract 47, Sacramento County, California",2577,141,1186,134,1391,170
6067004801,"Census Tract 48.01, Sacramento County, California",1621,94,1134,131,487,134
6067004802,"Census Tract 48.02, Sacramento County, California",1348,111,774,120,574,130
6067004903,"Census Tract 49.03, Sacramento County, California",1826,179,834,163,992,208
6067004904,"Census Tract 49.04, Sacramento County, California",1845,129,1249,148,596,124
6067004905,"Census Tract 49.05, Sacramento County, California",2246,135,750,154,1496,185
6067004906,"Census Tract 49.06, Sacramento County, California",735,98,454,94,281,91
6067005001,"Census Tract 50.01, Sacramento County, California",2289,157,1665,175,624,152
6067005002,"Census Tract 50.02, Sacramento County, California",2353,134,1144,188,1209,197
6067005101,"Census Tract 51.01, Sacramento County, California",1355,65,836,118,519,128
6067005102,"Census Tract 51.02, Sacramento County, California",1708,78,1117,116,591,132
6067005103,"Census Tract 51.03, Sacramento County, California",274,41,274,41,0,132
6067005201,"Census Tract 52.01, Sacramento County, California",804,76,0,132,804,76
6067005202,"Census Tract 52.02, Sacramento County, California",1472,81,1020,84,452,102
6067005203,"Census Tract 52.03, Sacramento County, California",3166,155,1617,186,1549,226
6067005300,"Census Tract 53, Sacramento County, California",290,54,34,37,256,64
6067005402,"Census Tract 54.02, Sacramento County, California",1551,88,36,56,1515,104
6067005403,"Census Tract 54.03, Sacramento County, California",1349,69,968,81,381,63
6067005404,"Census Tract 54.04, Sacramento County, California",2862,157,1714,129,1148,175
6067005502,"Census Tract 55.02, Sacramento County, California",1962,134,623,119,1339,171
6067005505,"Census Tract 55.05, Sacramento County, California",1965,123,467,117,1498,153
6067005506,"Census Tract 55.06, Sacramento County, California",1232,114,253,66,979,121
6067005507,"Census Tract 55.07, Sacramento County, California",3199,166,458,152,2741,191
6067005508,"Census Tract 55.08, Sacramento County, California",1796,119,614,123,1182,147
6067005601,"Census Tract 56.01, Sacramento County, California",2190,119,1082,129,1108,151
6067005605,"Census Tract 56.05, Sacramento County, California",1215,105,504,72,711,120
6067005606,"Census Tract 56.06, Sacramento County, California",1839,99,1122,164,717,161
6067005701,"Census Tract 57.01, Sacramento County, California",1336,54,950,108,386,115
6067005702,"Census Tract 57.02, Sacramento County, California",1903,38,1710,88,193,84
6067005801,"Census Tract 58.01, Sacramento County, California",2220,85,1694,142,526,121
6067005803,"Census Tract 58.03, Sacramento County, California",1489,45,1370,71,119,53
6067005804,"Census Tract 58.04, Sacramento County, California",1078,78,887,69,191,63
6067005901,"Census Tract 59.01, Sacramento County, California",2510,82,1846,186,664,186
6067005902,"Census Tract 59.02, Sacramento County, California",3115,188,1539,150,1576,222
6067006002,"Census Tract 60.02, Sacramento County, California",2131,104,899,140,1232,172
6067006003,"Census Tract 60.03, Sacramento County, California",1791,131,690,108,1101,149
6067006004,"Census Tract 60.04, Sacramento County, California",1038,56,822,72,216,67
6067006101,"Census Tract 61.01, Sacramento County, California",2030,173,1057,170,973,170
6067006102,"Census Tract 61.02, Sacramento County, California",1697,162,448,87,1249,160
6067006201,"Census Tract 62.01, Sacramento County, California",2600,219,1039,160,1561,210
6067006202,"Census Tract 62.02, Sacramento County, California",1592,77,685,92,907,94
6067006300,"Census Tract 63, Sacramento County, California",1557,143,889,112,668,114
6067006400,"Census Tract 64, Sacramento County, California",1790,104,984,120,806,124
6067006500,"Census Tract 65, Sacramento County, California",1799,122,847,151,952,132
6067006600,"Census Tract 66, Sacramento County, California",2151,143,940,179,1211,196
6067006701,"Census Tract 67.01, Sacramento County, California",2471,101,1131,153,1340,146
6067006702,"Census Tract 67.02, Sacramento County, California",1822,147,818,136,1004,174
6067006800,"Census Tract 68, Sacramento County, California",2224,144,934,179,1290,192
6067006900,"Census Tract 69, Sacramento County, California",2136,164,901,162,1235,179
6067007001,"Census Tract 70.01, Sacramento County, California",1125,99,652,111,473,114
6067007004,"Census Tract 70.04, Sacramento County, California",2470,179,1029,176,1441,203
6067007007,"Census Tract 70.07, Sacramento County, California",1463,106,947,132,516,138
6067007008,"Census Tract 70.08, Sacramento County, California",5660,264,2957,257,2703,333
6067007009,"Census Tract 70.09, Sacramento County, California",1561,89,1003,117,558,144
6067007010,"Census Tract 70.10, Sacramento County, California",1893,105,232,99,1661,136
6067007011,"Census Tract 70.11, Sacramento County, California",2438,110,679,120,1759,150
6067007012,"Census Tract 70.12, Sacramento County, California",1297,117,877,145,420,120
6067007013,"Census Tract 70.13, Sacramento County, California",1032,53,556,101,476,113
6067007014,"Census Tract 70.14, Sacramento County, California",2676,144,1327,172,1349,164
6067007100,"Census Tract 71, Sacramento County, California",11827,329,8177,388,3650,361
6067007202,"Census Tract 72.02, Sacramento County, California",1261,85,847,90,414,104
6067007204,"Census Tract 72.04, Sacramento County, California",1502,77,1065,132,437,118
6067007206,"Census Tract 72.06, Sacramento County, California",1295,67,1199,80,96,52
6067007207,"Census Tract 72.07, Sacramento County, California",1410,63,1031,103,379,109
6067007208,"Census Tract 72.08, Sacramento County, California",1385,106,1108,116,277,95
6067007209,"Census Tract 72.09, Sacramento County, California",1271,65,974,115,297,101
6067007300,"Census Tract 73, Sacramento County, California",130,82,0,132,130,82
6067007402,"Census Tract 74.02, Sacramento County, California",2054,74,1649,155,405,141
6067007403,"Census Tract 74.03, Sacramento County, California",1275,112,923,140,352,117
6067007404,"Census Tract 74.04, Sacramento County, California",1472,77,722,130,750,142
6067007406,"Census Tract 74.06, Sacramento County, California",2254,146,1642,205,612,175
6067007413,"Census Tract 74.13, Sacramento County, California",2336,155,1277,242,1059,215
6067007414,"Census Tract 74.14, Sacramento County, California",1413,64,737,121,676,118
6067007415,"Census Tract 74.15, Sacramento County, California",1162,77,939,108,223,96
6067007416,"Census Tract 74.16, Sacramento County, California",1511,64,989,111,522,117
6067007417,"Census Tract 74.17, Sacramento County, California",801,99,673,97,128,66
6067007418,"Census Tract 74.18, Sacramento County, California",3622,115,2828,206,794,190
6067007419,"Census Tract 74.19, Sacramento County, California",4037,160,3095,278,942,256
6067007420,"Census Tract 74.20, Sacramento County, California",3099,111,1746,249,1353,240
6067007421,"Census Tract 74.21, Sacramento County, California",2540,125,2315,163,225,101
6067007422,"Census Tract 74.22, Sacramento County, California",779,92,300,87,479,109
6067007423,"Census Tract 74.23, Sacramento County, California",1818,141,398,99,1420,154
6067007424,"Census Tract 74.24, Sacramento County, California",1255,84,532,107,723,111
6067007425,"Census Tract 74.25, Sacramento County, California",3040,158,1641,211,1399,217
6067007501,"Census Tract 75.01, Sacramento County, California",2482,142,995,158,1487,179
6067007503,"Census Tract 75.03, Sacramento County, California",2046,170,736,120,1310,191
6067007504,"Census Tract 75.04, Sacramento County, California",757,79,424,88,333,79
6067007601,"Census Tract 76.01, Sacramento County, California",2896,134,1397,133,1499,163
6067007602,"Census Tract 76.02, Sacramento County, California",1836,115,1048,126,788,115
6067007701,"Census Tract 77.01, Sacramento County, California",2484,178,1056,145,1428,201
6067007702,"Census Tract 77.02, Sacramento County, California",1958,99,1315,120,643,145
6067007801,"Census Tract 78.01, Sacramento County, California",2399,148,1204,178,1195,200
6067007802,"Census Tract 78.02, Sacramento County, California",1846,136,966,109,880,149
6067007903,"Census Tract 79.03, Sacramento County, California",1879,82,1328,109,551,125
6067007904,"Census Tract 79.04, Sacramento County, California",1860,100,1360,143,500,160
6067007905,"Census Tract 79.05, Sacramento County, California",1680,94,1347,93,333,89
6067007906,"Census Tract 79.06, Sacramento County, California",1559,85,962,92,597,92
6067008005,"Census Tract 80.05, Sacramento County, California",1898,75,1767,94,131,66
6067008006,"Census Tract 80.06, Sacramento County, California",2538,87,1834,141,704,147
6067008007,"Census Tract 80.07, Sacramento County, California",1421,69,817,102,604,113
6067008008,"Census Tract 80.08, Sacramento County, California",1876,82,1425,118,451,119
6067008009,"Census Tract 80.09, Sacramento County, California",1931,122,1103,121,828,123
6067008010,"Census Tract 80.10, Sacramento County, California",2021,115,1429,141,592,157
6067008111,"Census Tract 81.11, Sacramento County, California",2373,92,1804,142,569,150
6067008113,"Census Tract 81.13, Sacramento County, California",1342,101,748,106,594,111
6067008117,"Census Tract 81.17, Sacramento County, California",814,52,658,76,156,75
6067008119,"Census Tract 81.19, Sacramento County, California",2095,118,1415,146,680,168
6067008120,"Census Tract 81.20, Sacramento County, California",1934,100,886,141,1048,165
6067008122,"Census Tract 81.22, Sacramento County, California",1384,67,864,103,520,103
6067008124,"Census Tract 81.24, Sacramento County, California",1609,66,1483,84,126,79
6067008125,"Census Tract 81.25, Sacramento County, California",1973,115,1540,161,433,166
6067008127,"Census Tract 81.27, Sacramento County, California",1707,78,1193,146,514,126
6067008128,"Census Tract 81.28, Sacramento County, California",916,69,688,94,228,89
6067008129,"Census Tract 81.29, Sacramento County, California",1317,69,1068,114,249,95
6067008130,"Census Tract 81.30, Sacramento County, California",1312,76,1090,97,222,83
6067008131,"Census Tract 81.31, Sacramento County, California",2351,149,1499,161,852,155
6067008132,"Census Tract 81.32, Sacramento County, California",1520,67,1276,75,244,75
6067008133,"Census Tract 81.33, Sacramento County, California",1185,77,382,101,803,112
6067008134,"Census Tract 81.34, Sacramento County, California",1797,148,1000,155,797,173
6067008135,"Census Tract 81.35, Sacramento County, California",2142,123,1175,159,967,165
6067008136,"Census Tract 81.36, Sacramento County, California",1348,51,345,84,1003,96
6067008137,"Census Tract 81.37, Sacramento County, California",959,58,380,100,579,107
6067008138,"Census Tract 81.38, Sacramento County, California",1265,101,829,100,436,100
6067008139,"Census Tract 81.39, Sacramento County, California",1754,92,383,84,1371,126
6067008140,"Census Tract 81.40, Sacramento County, California",982,86,583,124,399,113
6067008141,"Census Tract 81.41, Sacramento County, California",2671,179,857,163,1814,204
6067008142,"Census Tract 81.42, Sacramento County, California",1408,67,517,78,891,102
6067008143,"Census Tract 81.43, Sacramento County, California",1623,102,713,115,910,147
6067008144,"Census Tract 81.44, Sacramento County, California",895,42,819,70,76,51
6067008145,"Census Tract 81.45, Sacramento County, California",2654,86,2179,153,475,124
6067008203,"Census Tract 82.03, Sacramento County, California",1793,77,1527,100,266,97
6067008204,"Census Tract 82.04, Sacramento County, California",1699,109,1357,129,342,127
6067008206,"Census Tract 82.06, Sacramento County, California",1941,135,1378,166,563,154
6067008207,"Census Tract 82.07, Sacramento County, California",1742,71,1243,118,499,125
6067008208,"Census Tract 82.08, Sacramento County, California",1837,83,1055,131,782,130
6067008209,"Census Tract 82.09, Sacramento County, California",1617,78,1059,96,558,105
6067008210,"Census Tract 82.10, Sacramento County, California",2177,111,1834,109,343,81
6067008211,"Census Tract 82.11, Sacramento County, California",1053,20,823,114,230,120
6067008300,"Census Tract 83, Sacramento County, California",20,16,0,132,20,16
6067008402,"Census Tract 84.02, Sacramento County, California",1860,67,1399,107,461,101
6067008403,"Census Tract 84.03, Sacramento County, California",1915,99,1032,160,883,146
6067008404,"Census Tract 84.04, Sacramento County, California",1290,87,577,92,713,112
6067008501,"Census Tract 85.01, Sacramento County, California",2065,87,1830,112,235,103
6067008502,"Census Tract 85.02, Sacramento County, California",5519,207,4026,164,1493,181
6067008503,"Census Tract 85.03, Sacramento County, California",4024,142,3035,222,989,208
6067008504,"Census Tract 85.04, Sacramento County, California",1408,81,1158,68,250,73
6067008600,"Census Tract 86, Sacramento County, California",2752,111,2567,103,185,90
6067008701,"Census Tract 87.01, Sacramento County, California",3863,196,2976,220,887,191
6067008702,"Census Tract 87.02, Sacramento County, California",1351,31,1293,49,58,38
6067008800,"Census Tract 88, Sacramento County, California",1681,72,1301,111,380,97
6067008905,"Census Tract 89.05, Sacramento County, California",1643,106,922,124,721,116
6067008907,"Census Tract 89.07, Sacramento County, California",1880,99,968,120,912,131
6067008908,"Census Tract 89.08, Sacramento County, California",1972,169,1249,189,723,170
6067008909,"Census Tract 89.09, Sacramento County, California",814,85,634,81,180,75
6067008910,"Census Tract 89.10, Sacramento County, California",1367,70,756,103,611,108
6067008911,"Census Tract 89.11, Sacramento County, California",827,54,251,50,576,73
6067008912,"Census Tract 89.12, Sacramento County, California",1271,110,1097,131,174,76
6067008913,"Census Tract 89.13, Sacramento County, California",1437,109,898,136,539,116
6067009004,"Census Tract 90.04, Sacramento County, California",1237,104,886,118,351,113
6067009005,"Census Tract 90.05, Sacramento County, California",1250,75,530,96,720,112
6067009006,"Census Tract 90.06, Sacramento County, California",1803,113,966,115,837,118
6067009007,"Census Tract 90.07, Sacramento County, California",1070,61,311,86,759,104
6067009008,"Census Tract 90.08, Sacramento County, California",1627,112,936,134,691,150
6067009009,"Census Tract 90.09, Sacramento County, California",3106,190,1115,194,1991,237
6067009103,"Census Tract 91.03, Sacramento County, California",1226,66,804,100,422,98
6067009105,"Census Tract 91.05, Sacramento County, California",1091,70,610,105,481,102
6067009106,"Census Tract 91.06, Sacramento County, California",1813,123,912,126,901,144
6067009107,"Census Tract 91.07, Sacramento County, California",1320,74,970,95,350,96
6067009108,"Census Tract 91.08, Sacramento County, California",1390,51,911,133,479,132
6067009109,"Census Tract 91.09, Sacramento County, California",1758,71,1365,136,393,114
6067009110,"Census Tract 91.10, Sacramento County, California",630,91,147,81,483,95
6067009111,"Census Tract 91.11, Sacramento County, California",2200,112,1142,135,1058,159
6067009112,"Census Tract 91.12, Sacramento County, California",1316,69,826,122,490,105
6067009200,"Census Tract 92, Sacramento County, California",439,78,331,85,108,72
6067009307,"Census Tract 93.07, Sacramento County, California",1480,76,1060,89,420,93
6067009308,"Census Tract 93.08, Sacramento County, California",1850,83,1474,107,376,108
6067009309,"Census Tract 93.09, Sacramento County, California",818,21,796,31,22,22
6067009310,"Census Tract 93.10, Sacramento County, California",2095,127,1609,149,486,153
6067009311,"Census Tract 93.11, Sacramento County, California",1963,72,1624,147,339,133
6067009312,"Census Tract 93.12, Sacramento County, California",1819,134,1553,154,266,94
6067009313,"Census Tract 93.13, Sacramento County, California",718,56,436,72,282,64
6067009314,"Census Tract 93.14, Sacramento County, California",1308,80,1130,81,178,79
6067009315,"Census Tract 93.15, Sacramento County, California",6559,211,5924,255,635,180
6067009316,"Census Tract 93.16, Sacramento County, California",1224,115,888,154,336,101
6067009317,"Census Tract 93.17, Sacramento County, California",1670,92,1471,96,199,83
6067009318,"Census Tract 93.18, Sacramento County, California",799,34,638,61,161,54
6067009319,"Census Tract 93.19, Sacramento County, California",1165,89,913,96,252,78
6067009320,"Census Tract 93.20, Sacramento County, California",1377,72,790,126,587,127
6067009321,"Census Tract 93.21, Sacramento County, California",1682,76,1452,105,230,77
6067009322,"Census Tract 93.22, Sacramento County, California",3028,125,2186,202,842,192
6067009323,"Census Tract 93.23, Sacramento County, California",1302,86,1152,110,150,83
6067009403,"Census Tract 94.03, Sacramento County, California",645,85,509,92,136,86
6067009404,"Census Tract 94.04, Sacramento County, California",1773,133,1621,144,152,91
6067009405,"Census Tract 94.05, Sacramento County, California",3289,162,2685,215,604,171
6067009406,"Census Tract 94.06, Sacramento County, California",719,44,628,66,91,63
6067009501,"Census Tract 95.01, Sacramento County, California",832,35,692,64,140,65
6067009502,"Census Tract 95.02, Sacramento County, California",2065,111,1753,142,312,129
6067009503,"Census Tract 95.03, Sacramento County, California",1172,79,715,113,457,107
6067009504,"Census Tract 95.04, Sacramento County, California",693,73,498,85,195,75
6067009601,"Census Tract 96.01, Sacramento County, California",1790,86,1196,143,594,122
6067009604,"Census Tract 96.04, Sacramento County, California",10764,362,8342,407,2422,292
6067009605,"Census Tract 96.05, Sacramento County, California",148,48,98,32,50,49
6067009606,"Census Tract 96.06, Sacramento County, California",2306,154,1097,182,1209,186
6067009607,"Census Tract 96.07, Sacramento County, California",2469,153,1091,186,1378,214
6067009608,"Census Tract 96.08, Sacramento County, California",1628,141,1031,119,597,155
6067009609,"Census Tract 96.09, Sacramento County, California",1465,65,1038,121,427,126
6067009610,"Census Tract 96.10, Sacramento County, California",1707,94,1168,133,539,141
6067009611,"Census Tract 96.11, Sacramento County, California",890,51,614,73,276,79
6067009612,"Census Tract 96.12, Sacramento County, California",1496,82,972,105,524,105
6067009613,"Census Tract 96.13, Sacramento County, California",941,54,481,77,460,84
6067009614,"Census Tract 96.14, Sacramento County, California",1980,76,1564,151,416,126
6067009615,"Census Tract 96.15, Sacramento County, California",2453,89,1768,134,685,139
6067009616,"Census Tract 96.16, Sacramento County, California",1739,70,1387,130,352,118
6067009617,"Census Tract 96.17, Sacramento County, California",1079,85,915,101,164,84
6067009618,"Census Tract 96.18, Sacramento County, California",1390,47,1079,99,311,89
6067009619,"Census Tract 96.19, Sacramento County, California",2366,91,1759,139,607,125
6067009700,"Census Tract 97, Sacramento County, California",1030,89,672,143,358,120
6067009800,"Census Tract 98, Sacramento County, California",931,102,743,119,188,76
6069000100,"Census Tract 1, San Benito County, California",1447,258,932,164,515,146
6069000200,"Census Tract 2, San Benito County, California",1677,308,1164,235,513,142
6069000300,"Census Tract 3, San Benito County, California",971,108,524,102,447,132
6069000400,"Census Tract 4, San Benito County, California",1952,149,918,149,1034,166
6069000500,"Census Tract 5, San Benito County, California",3218,208,2317,229,901,233
6069000600,"Census Tract 6, San Benito County, California",2682,124,2054,189,628,175
6069000700,"Census Tract 7, San Benito County, California",2776,152,1569,251,1207,241
6069000800,"Census Tract 8, San Benito County, California",1948,271,1611,231,337,92
6071000103,"Census Tract 1.03, San Bernardino County, California",1563,101,1135,143,428,107
6071000104,"Census Tract 1.04, San Bernardino County, California",1808,51,1476,93,332,83
6071000105,"Census Tract 1.05, San Bernardino County, California",1782,76,1449,91,333,88
6071000106,"Census Tract 1.06, San Bernardino County, California",3323,108,3035,139,288,98
6071000107,"Census Tract 1.07, San Bernardino County, California",893,60,747,60,146,72
6071000108,"Census Tract 1.08, San Bernardino County, California",1617,78,1135,85,482,90
6071000109,"Census Tract 1.09, San Bernardino County, California",2023,83,1828,133,195,101
6071000110,"Census Tract 1.10, San Bernardino County, California",3136,143,2212,191,924,182
6071000111,"Census Tract 1.11, San Bernardino County, California",778,62,735,61,43,40
6071000112,"Census Tract 1.12, San Bernardino County, California",5138,169,4604,177,534,131
6071000201,"Census Tract 2.01, San Bernardino County, California",1188,74,629,98,559,117
6071000202,"Census Tract 2.02, San Bernardino County, California",4545,210,3215,271,1330,277
6071000301,"Census Tract 3.01, San Bernardino County, California",1978,100,530,110,1448,129
6071000303,"Census Tract 3.03, San Bernardino County, California",1798,89,1182,134,616,137
6071000304,"Census Tract 3.04, San Bernardino County, California",1368,102,919,121,449,111
6071000401,"Census Tract 4.01, San Bernardino County, California",1909,95,1645,126,264,107
6071000402,"Census Tract 4.02, San Bernardino County, California",3107,192,1778,203,1329,232
6071000500,"Census Tract 5, San Bernardino County, California",5240,205,3899,256,1341,250
6071000601,"Census Tract 6.01, San Bernardino County, California",3608,128,2019,218,1589,222
6071000602,"Census Tract 6.02, San Bernardino County, California",2392,142,1482,162,910,156
6071000700,"Census Tract 7, San Bernardino County, California",174,74,133,63,41,56
6071000804,"Census Tract 8.04, San Bernardino County, California",1256,71,992,82,264,94
6071000805,"Census Tract 8.05, San Bernardino County, California",2436,124,2370,129,66,43
6071000806,"Census Tract 8.06, San Bernardino County, California",2483,113,2409,122,74,57
6071000807,"Census Tract 8.07, San Bernardino County, California",2847,143,2365,136,482,146
6071000808,"Census Tract 8.08, San Bernardino County, California",1930,89,1527,143,403,126
6071000809,"Census Tract 8.09, San Bernardino County, California",3007,150,2304,173,703,180
6071000810,"Census Tract 8.10, San Bernardino County, California",4998,193,1272,179,3726,245
6071000811,"Census Tract 8.11, San Bernardino County, California",2706,134,938,178,1768,201
6071000812,"Census Tract 8.12, San Bernardino County, California",1378,49,1169,92,209,80
6071000900,"Census Tract 9, San Bernardino County, California",4210,142,1357,168,2853,226
6071001000,"Census Tract 10, San Bernardino County, California",2916,155,1370,203,1546,210
6071001100,"Census Tract 11, San Bernardino County, California",4401,203,2714,250,1687,291
6071001200,"Census Tract 12, San Bernardino County, California",1613,98,1315,133,298,106
6071001301,"Census Tract 13.01, San Bernardino County, California",2857,112,1962,212,895,216
6071001303,"Census Tract 13.03, San Bernardino County, California",3769,145,2373,216,1396,217
6071001304,"Census Tract 13.04, San Bernardino County, California",2247,127,1810,143,437,146
6071001400,"Census Tract 14, San Bernardino County, California",904,99,211,84,693,116
6071001500,"Census Tract 15, San Bernardino County, California",3289,160,1170,171,2119,215
6071001600,"Census Tract 16, San Bernardino County, California",1429,110,540,109,889,153
6071001701,"Census Tract 17.01, San Bernardino County, California",4880,190,3092,238,1788,243
6071001702,"Census Tract 17.02, San Bernardino County, California",1582,93,872,126,710,131
6071001703,"Census Tract 17.03, San Bernardino County, California",1863,118,1444,147,419,129
6071001801,"Census Tract 18.01, San Bernardino County, California",3225,192,1664,208,1561,245
6071001802,"Census Tract 18.02, San Bernardino County, California",5477,165,4319,234,1158,206
6071001803,"Census Tract 18.03, San Bernardino County, California",909,97,779,102,130,62
6071001900,"Census Tract 19, San Bernardino County, California",6574,244,4909,277,1665,247
6071002002,"Census Tract 20.02, San Bernardino County, California",3710,109,3271,165,439,156
6071002003,"Census Tract 20.03, San Bernardino County, California",4559,143,3976,193,583,145
6071002004,"Census Tract 20.04, San Bernardino County, California",2956,100,2190,205,766,205
6071002005,"Census Tract 20.05, San Bernardino County, California",7849,236,5072,287,2777,325
6071002006,"Census Tract 20.06, San Bernardino County, California",6582,217,3083,291,3499,289
6071002007,"Census Tract 20.07, San Bernardino County, California",10121,271,8295,362,1826,294
6071002008,"Census Tract 20.08, San Bernardino County, California",3286,102,2890,157,396,126
6071002009,"Census Tract 20.09, San Bernardino County, California",6256,228,5030,294,1226,238
6071002010,"Census Tract 20.10, San Bernardino County, California",1773,114,1683,127,90,86
6071002100,"Census Tract 21, San Bernardino County, California",11416,364,4113,317,7303,383
6071002201,"Census Tract 22.01, San Bernardino County, California",3618,134,2749,240,869,206
6071002203,"Census Tract 22.03, San Bernardino County, California",504,55,104,62,400,81
6071002204,"Census Tract 22.04, San Bernardino County, California",1570,94,1081,140,489,136
6071002301,"Census Tract 23.01, San Bernardino County, California",1914,103,1587,135,327,119
6071002302,"Census Tract 23.02, San Bernardino County, California",1933,110,1630,147,303,130
6071002303,"Census Tract 23.03, San Bernardino County, California",6607,259,5850,341,757,211
6071002401,"Census Tract 24.01, San Bernardino County, California",1823,84,1266,126,557,116
6071002402,"Census Tract 24.02, San Bernardino County, California",1777,109,1004,130,773,141
6071002501,"Census Tract 25.01, San Bernardino County, California",1279,87,1035,89,244,89
6071002502,"Census Tract 25.02, San Bernardino County, California",1458,85,1148,115,310,91
6071002601,"Census Tract 26.01, San Bernardino County, California",2222,138,1620,176,602,212
6071002602,"Census Tract 26.02, San Bernardino County, California",1853,67,1460,120,393,118
6071002603,"Census Tract 26.03, San Bernardino County, California",4516,195,3811,224,705,166
6071002701,"Census Tract 27.01, San Bernardino County, California",4187,147,3660,226,527,174
6071002702,"Census Tract 27.02, San Bernardino County, California",2992,137,2711,175,281,138
6071002800,"Census Tract 28, San Bernardino County, California",3231,157,1254,155,1977,187
6071002901,"Census Tract 29.01, San Bernardino County, California",1013,81,433,96,580,103
6071002902,"Census Tract 29.02, San Bernardino County, California",1640,85,858,129,782,123
6071003000,"Census Tract 30, San Bernardino County, California",876,55,356,81,520,93
6071003100,"Census Tract 31, San Bernardino County, California",2481,92,1042,163,1439,172
6071003200,"Census Tract 32, San Bernardino County, California",1870,110,1434,126,436,121
6071003300,"Census Tract 33, San Bernardino County, California",3072,91,1570,180,1502,185
6071003401,"Census Tract 34.01, San Bernardino County, California",1657,67,1121,128,536,134
6071003402,"Census Tract 34.02, San Bernardino County, California",2451,149,764,144,1687,214
6071003403,"Census Tract 34.03, San Bernardino County, California",1044,79,766,130,278,125
6071003501,"Census Tract 35.01, San Bernardino County, California",3376,167,2097,211,1279,211
6071003502,"Census Tract 35.02, San Bernardino County, California",3929,199,2551,198,1378,223
6071003601,"Census Tract 36.01, San Bernardino County, California",4712,196,2975,212,1737,241
6071003602,"Census Tract 36.02, San Bernardino County, California",3378,151,2898,185,480,140
6071003700,"Census Tract 37, San Bernardino County, California",1261,79,253,76,1008,100
6071003800,"Census Tract 38, San Bernardino County, California",3323,183,2396,216,927,168
6071003900,"Census Tract 39, San Bernardino County, California",1315,85,1005,102,310,99
6071004000,"Census Tract 40, San Bernardino County, California",3830,138,2995,246,835,202
6071004100,"Census Tract 41, San Bernardino County, California",3577,167,2404,239,1173,235
6071004201,"Census Tract 42.01, San Bernardino County, California",1463,100,931,124,532,120
6071004202,"Census Tract 42.02, San Bernardino County, California",1376,88,722,156,654,143
6071004300,"Census Tract 43, San Bernardino County, California",2116,99,1479,184,637,178
6071004401,"Census Tract 44.01, San Bernardino County, California",1023,93,908,98,115,53
6071004402,"Census Tract 44.02, San Bernardino County, California",2831,130,1798,205,1033,188
6071004502,"Census Tract 45.02, San Bernardino County, California",5920,227,3278,270,2642,284
6071004503,"Census Tract 45.03, San Bernardino County, California",867,87,811,97,56,39
6071004504,"Census Tract 45.04, San Bernardino County, California",2283,89,1644,111,639,107
6071004601,"Census Tract 46.01, San Bernardino County, California",2345,96,1043,185,1302,194
6071004602,"Census Tract 46.02, San Bernardino County, California",3540,166,2305,224,1235,235
6071004700,"Census Tract 47, San Bernardino County, California",1350,89,817,120,533,122
6071004800,"Census Tract 48, San Bernardino County, California",722,77,386,82,336,106
6071004900,"Census Tract 49, San Bernardino County, California",1712,108,783,150,929,146
6071005000,"Census Tract 50, San Bernardino County, California",476,78,275,66,201,68
6071005100,"Census Tract 51, San Bernardino County, California",2707,126,1731,220,976,229
6071005200,"Census Tract 52, San Bernardino County, California",1339,73,791,91,548,91
6071005300,"Census Tract 53, San Bernardino County, California",1651,79,997,136,654,119
6071005400,"Census Tract 54, San Bernardino County, California",1836,113,601,117,1235,147
6071005500,"Census Tract 55, San Bernardino County, California",2360,156,405,136,1955,189
6071005600,"Census Tract 56, San Bernardino County, California",1768,96,482,111,1286,123
6071005700,"Census Tract 57, San Bernardino County, California",589,59,42,43,547,81
6071005800,"Census Tract 58, San Bernardino County, California",1203,118,304,84,899,142
6071005900,"Census Tract 59, San Bernardino County, California",366,29,91,36,275,44
6071006000,"Census Tract 60, San Bernardino County, California",389,54,261,66,128,72
6071006100,"Census Tract 61, San Bernardino County, California",2484,190,1761,279,723,221
6071006201,"Census Tract 62.01, San Bernardino County, California",1049,47,801,107,248,97
6071006202,"Census Tract 62.02, San Bernardino County, California",2747,165,550,129,2197,197
6071006301,"Census Tract 63.01, San Bernardino County, California",1408,75,591,75,817,112
6071006302,"Census Tract 63.02, San Bernardino County, California",2200,171,1257,211,943,229
6071006401,"Census Tract 64.01, San Bernardino County, California",782,78,336,88,446,93
6071006402,"Census Tract 64.02, San Bernardino County, California",1151,69,407,102,744,113
6071006500,"Census Tract 65, San Bernardino County, California",1753,112,504,126,1249,158
6071006600,"Census Tract 66, San Bernardino County, California",3732,165,2479,240,1253,226
6071006700,"Census Tract 67, San Bernardino County, California",1057,94,636,127,421,115
6071006800,"Census Tract 68, San Bernardino County, California",301,62,145,48,156,59
6071006900,"Census Tract 69, San Bernardino County, California",786,78,451,86,335,95
6071007000,"Census Tract 70, San Bernardino County, California",2069,126,1008,181,1061,191
6071007102,"Census Tract 71.02, San Bernardino County, California",3832,156,1787,216,2045,229
6071007104,"Census Tract 71.04, San Bernardino County, California",1394,90,1113,105,281,90
6071007105,"Census Tract 71.05, San Bernardino County, California",1134,81,688,123,446,111
6071007106,"Census Tract 71.06, San Bernardino County, California",1336,104,807,102,529,108
6071007107,"Census Tract 71.07, San Bernardino County, California",1040,86,525,94,515,107
6071007108,"Census Tract 71.08, San Bernardino County, California",993,91,95,58,898,100
6071007200,"Census Tract 72, San Bernardino County, California",1835,112,1104,131,731,139
6071007301,"Census Tract 73.01, San Bernardino County, California",5309,308,1274,188,4035,336
6071007302,"Census Tract 73.02, San Bernardino County, California",3396,207,2187,218,1209,207
6071007403,"Census Tract 74.03, San Bernardino County, California",2440,67,1734,182,706,183
6071007404,"Census Tract 74.04, San Bernardino County, California",1626,103,1421,115,205,94
6071007406,"Census Tract 74.06, San Bernardino County, California",3410,163,2072,200,1338,210
6071007407,"Census Tract 74.07, San Bernardino County, California",751,107,241,73,510,116
6071007408,"Census Tract 74.08, San Bernardino County, California",1120,78,366,88,754,101
6071007500,"Census Tract 75, San Bernardino County, California",0,132,0,132,0,132
6071007601,"Census Tract 76.01, San Bernardino County, California",1795,109,769,127,1026,137
6071007602,"Census Tract 76.02, San Bernardino County, California",2460,129,1572,189,888,165
6071007700,"Census Tract 77, San Bernardino County, California",0,132,0,132,0,132
6071007800,"Census Tract 78, San Bernardino County, California",1884,154,407,101,1477,174
6071007901,"Census Tract 79.01, San Bernardino County, California",2258,92,2008,123,250,91
6071007902,"Census Tract 79.02, San Bernardino County, California",3200,152,2917,186,283,135
6071008001,"Census Tract 80.01, San Bernardino County, California",1892,88,1365,147,527,126
6071008002,"Census Tract 80.02, San Bernardino County, California",1968,128,665,96,1303,149
6071008100,"Census Tract 81, San Bernardino County, California",1514,104,263,90,1251,132
6071008200,"Census Tract 82, San Bernardino County, California",2562,125,1087,142,1475,170
6071008301,"Census Tract 83.01, San Bernardino County, California",2703,123,1596,175,1107,193
6071008302,"Census Tract 83.02, San Bernardino County, California",1222,79,1049,86,173,76
6071008401,"Census Tract 84.01, San Bernardino County, California",2909,149,2300,182,609,167
6071008402,"Census Tract 84.02, San Bernardino County, California",2218,126,1810,160,408,155
6071008403,"Census Tract 84.03, San Bernardino County, California",2029,115,1730,127,299,100
6071008404,"Census Tract 84.04, San Bernardino County, California",895,126,85,49,810,122
6071008500,"Census Tract 85, San Bernardino County, California",3097,152,2780,197,317,170
6071008600,"Census Tract 86, San Bernardino County, California",3304,209,1856,243,1448,246
6071008703,"Census Tract 87.03, San Bernardino County, California",2678,149,2573,146,105,70
6071008704,"Census Tract 87.04, San Bernardino County, California",2666,160,2014,208,652,198
6071008705,"Census Tract 87.05, San Bernardino County, California",1471,105,818,106,653,122
6071008706,"Census Tract 87.06, San Bernardino County, California",3856,167,3274,232,582,169
6071008707,"Census Tract 87.07, San Bernardino County, California",3163,186,2091,221,1072,203
6071008708,"Census Tract 87.08, San Bernardino County, California",1324,84,1164,103,160,64
6071008800,"Census Tract 88, San Bernardino County, California",2099,149,1543,162,556,159
6071008901,"Census Tract 89.01, San Bernardino County, California",1011,98,722,89,289,65
6071009102,"Census Tract 91.02, San Bernardino County, California",0,132,0,132,0,132
6071009104,"Census Tract 91.04, San Bernardino County, California",10685,494,7003,480,3682,415
6071009105,"Census Tract 91.05, San Bernardino County, California",6271,288,5146,307,1125,232
6071009106,"Census Tract 91.06, San Bernardino County, California",3652,217,2964,231,688,199
6071009107,"Census Tract 91.07, San Bernardino County, California",1970,158,1555,177,415,143
6071009200,"Census Tract 92, San Bernardino County, California",2447,271,2102,280,345,156
6071009300,"Census Tract 93, San Bernardino County, California",496,77,333,90,163,82
6071009400,"Census Tract 94, San Bernardino County, California",1127,153,339,97,788,165
6071009500,"Census Tract 95, San Bernardino County, California",2737,219,1242,213,1495,265
6071009707,"Census Tract 97.07, San Bernardino County, California",2289,165,1735,160,554,163
6071009708,"Census Tract 97.08, San Bernardino County, California",1539,142,1253,131,286,129
6071009709,"Census Tract 97.09, San Bernardino County, California",1889,119,1333,164,556,138
6071009710,"Census Tract 97.10, San Bernardino County, California",2128,138,1070,151,1058,173
6071009711,"Census Tract 97.11, San Bernardino County, California",2928,152,2479,180,449,138
6071009712,"Census Tract 97.12, San Bernardino County, California",2130,128,1542,165,588,163
6071009713,"Census Tract 97.13, San Bernardino County, California",2120,133,1601,173,519,170
6071009714,"Census Tract 97.14, San Bernardino County, California",1110,84,870,94,240,78
6071009715,"Census Tract 97.15, San Bernardino County, California",2627,171,2155,216,472,168
6071009716,"Census Tract 97.16, San Bernardino County, California",2427,131,847,183,1580,202
6071009717,"Census Tract 97.17, San Bernardino County, California",1292,104,1087,119,205,78
6071009800,"Census Tract 98, San Bernardino County, California",1565,130,471,111,1094,118
6071009901,"Census Tract 99.01, San Bernardino County, California",4838,232,2494,298,2344,312
6071009902,"Census Tract 99.02, San Bernardino County, California",5946,256,4797,313,1149,292
6071009903,"Census Tract 99.03, San Bernardino County, California",3504,165,1999,233,1505,210
6071010003,"Census Tract 100.03, San Bernardino County, California",5147,249,3006,256,2141,234
6071010004,"Census Tract 100.04, San Bernardino County, California",2637,185,2043,270,594,230
6071010009,"Census Tract 100.09, San Bernardino County, California",973,84,816,115,157,90
6071010010,"Census Tract 100.10, San Bernardino County, California",1715,77,1163,115,552,107
6071010011,"Census Tract 100.11, San Bernardino County, California",1318,79,690,121,628,137
6071010012,"Census Tract 100.12, San Bernardino County, California",1346,61,1080,107,266,103
6071010013,"Census Tract 100.13, San Bernardino County, California",2161,103,1643,173,518,157
6071010014,"Census Tract 100.14, San Bernardino County, California",1129,94,626,114,503,120
6071010015,"Census Tract 100.15, San Bernardino County, California",1478,52,1016,119,462,118
6071010016,"Census Tract 100.16, San Bernardino County, California",1376,99,886,103,490,115
6071010017,"Census Tract 100.17, San Bernardino County, California",3296,183,2900,205,396,110
6071010018,"Census Tract 100.18, San Bernardino County, California",1713,111,1331,145,382,126
6071010019,"Census Tract 100.19, San Bernardino County, California",1348,105,925,82,423,121
6071010020,"Census Tract 100.20, San Bernardino County, California",2024,146,1011,170,1013,177
6071010021,"Census Tract 100.21, San Bernardino County, California",1797,135,1478,155,319,119
6071010022,"Census Tract 100.22, San Bernardino County, California",1308,57,1139,105,169,103
6071010023,"Census Tract 100.23, San Bernardino County, California",1652,95,1443,115,209,93
6071010024,"Census Tract 100.24, San Bernardino County, California",1456,67,1312,86,144,77
6071010300,"Census Tract 103, San Bernardino County, California",3667,257,939,183,2728,313
6071010402,"Census Tract 104.02, San Bernardino County, California",2200,195,152,38,2048,190
6071010403,"Census Tract 104.03, San Bernardino County, California",3859,232,2668,278,1191,255
6071010405,"Census Tract 104.05, San Bernardino County, California",3602,301,2925,332,677,210
6071010409,"Census Tract 104.09, San Bernardino County, California",1491,231,937,185,554,213
6071010410,"Census Tract 104.10, San Bernardino County, California",1112,124,796,135,316,106
6071010411,"Census Tract 104.11, San Bernardino County, California",2886,252,1815,242,1071,229
6071010412,"Census Tract 104.12, San Bernardino County, California",2901,246,2256,239,645,169
6071010413,"Census Tract 104.13, San Bernardino County, California",2557,217,1637,232,920,234
6071010414,"Census Tract 104.14, San Bernardino County, California",4332,290,1788,343,2544,358
6071010415,"Census Tract 104.15, San Bernardino County, California",2587,228,1335,179,1252,218
6071010416,"Census Tract 104.16, San Bernardino County, California",1570,181,1209,166,361,108
6071010500,"Census Tract 105, San Bernardino County, California",158,58,74,49,84,32
6071010600,"Census Tract 106, San Bernardino County, California",505,115,353,81,152,90
6071010700,"Census Tract 107, San Bernardino County, California",1713,130,894,135,819,143
6071010801,"Census Tract 108.01, San Bernardino County, California",1845,282,1367,276,478,161
6071010802,"Census Tract 108.02, San Bernardino County, California",1508,215,1068,192,440,147
6071010900,"Census Tract 109, San Bernardino County, California",2194,344,1931,331,263,137
6071011000,"Census Tract 110, San Bernardino County, California",1418,233,974,221,444,153
6071011100,"Census Tract 111, San Bernardino County, California",2266,317,1667,241,599,237
6071011201,"Census Tract 112.01, San Bernardino County, California",1361,233,912,237,449,122
6071011202,"Census Tract 112.02, San Bernardino County, California",1057,182,476,126,581,151
6071011300,"Census Tract 113, San Bernardino County, California",605,119,516,117,89,65
6071011400,"Census Tract 114, San Bernardino County, California",4243,349,2947,326,1296,280
6071011500,"Census Tract 115, San Bernardino County, California",644,126,565,117,79,76
6071011600,"Census Tract 116, San Bernardino County, California",2177,256,1878,232,299,122
6071011700,"Census Tract 117, San Bernardino County, California",490,65,315,66,175,55
6071011800,"Census Tract 118, San Bernardino County, California",2494,212,1535,205,959,192
6071011900,"Census Tract 119, San Bernardino County, California",1282,111,849,144,433,141
6071012000,"Census Tract 120, San Bernardino County, California",3951,255,2242,256,1709,297
6071012100,"Census Tract 121, San Bernardino County, California",4920,270,3703,276,1217,278
6071940100,"Census Tract 9401, San Bernardino County, California",710,113,570,109,140,62
6071940500,"Census Tract 9405, San Bernardino County, California",4,4,2,3,2,3
6073000100,"Census Tract 1, San Diego County, California",1330,75,1180,111,150,75
6073000200,"Census Tract 2, San Diego County, California",3354,132,1342,195,2012,210
6073000300,"Census Tract 3, San Diego County, California",2806,153,858,157,1948,183
6073000400,"Census Tract 4, San Diego County, California",2282,108,450,127,1832,156
6073000500,"Census Tract 5, San Diego County, California",1628,131,641,114,987,165
6073000600,"Census Tract 6, San Diego County, California",1883,96,673,118,1210,139
6073000700,"Census Tract 7, San Diego County, California",2260,182,624,144,1636,220
6073000800,"Census Tract 8, San Diego County, California",2567,142,888,171,1679,181
6073000900,"Census Tract 9, San Diego County, California",2904,150,422,130,2482,207
6073001000,"Census Tract 10, San Diego County, California",2664,96,409,117,2255,122
6073001100,"Census Tract 11, San Diego County, California",1610,108,416,95,1194,128
6073001200,"Census Tract 12, San Diego County, California",2913,132,394,123,2519,178
6073001300,"Census Tract 13, San Diego County, California",3168,140,527,147,2641,188
6073001400,"Census Tract 14, San Diego County, California",1420,111,585,102,835,114
6073001500,"Census Tract 15, San Diego County, California",1824,118,653,133,1171,155
6073001600,"Census Tract 16, San Diego County, California",2216,149,371,138,1845,214
6073001700,"Census Tract 17, San Diego County, California",2197,137,675,166,1522,191
6073001800,"Census Tract 18, San Diego County, California",2817,137,481,152,2336,190
6073001900,"Census Tract 19, San Diego County, California",1566,73,837,127,729,140
6073002001,"Census Tract 20.01, San Diego County, California",1617,65,1294,92,323,71
6073002002,"Census Tract 20.02, San Diego County, California",1166,68,867,82,299,71
6073002100,"Census Tract 21, San Diego County, California",2362,152,551,124,1811,160
6073002201,"Census Tract 22.01, San Diego County, California",1297,77,148,59,1149,105
6073002202,"Census Tract 22.02, San Diego County, California",1533,74,36,27,1497,74
6073002301,"Census Tract 23.01, San Diego County, California",1083,80,92,58,991,88
6073002302,"Census Tract 23.02, San Diego County, California",1964,126,384,121,1580,168
6073002401,"Census Tract 24.01, San Diego County, California",1656,83,408,118,1248,144
6073002402,"Census Tract 24.02, San Diego County, California",1476,87,155,89,1321,108
6073002501,"Census Tract 25.01, San Diego County, California",1488,107,710,131,778,145
6073002502,"Census Tract 25.02, San Diego County, California",1809,150,1036,152,773,178
6073002601,"Census Tract 26.01, San Diego County, California",1627,103,565,130,1062,134
6073002602,"Census Tract 26.02, San Diego County, California",1151,80,204,80,947,98
6073002702,"Census Tract 27.02, San Diego County, California",1872,91,739,104,1133,136
6073002703,"Census Tract 27.03, San Diego County, California",2309,106,1225,180,1084,177
6073002705,"Census Tract 27.05, San Diego County, California",1361,48,940,129,421,129
6073002706,"Census Tract 27.06, San Diego County, California",2610,138,1380,174,1230,215
6073002707,"Census Tract 27.07, San Diego County, California",1328,129,71,67,1257,138
6073002708,"Census Tract 27.08, San Diego County, California",1804,163,181,74,1623,172
6073002709,"Census Tract 27.09, San Diego County, California",1107,92,458,92,649,102
6073002710,"Census Tract 27.10, San Diego County, California",1047,92,309,89,738,108
6073002801,"Census Tract 28.01, San Diego County, California",986,72,313,47,673,77
6073002803,"Census Tract 28.03, San Diego County, California",2288,187,873,164,1415,224
6073002804,"Census Tract 28.04, San Diego County, California",1455,84,1048,116,407,117
6073002902,"Census Tract 29.02, San Diego County, California",2254,135,1165,196,1089,173
6073002903,"Census Tract 29.03, San Diego County, California",1383,60,986,113,397,110
6073002904,"Census Tract 29.04, San Diego County, California",1936,109,595,122,1341,160
6073002905,"Census Tract 29.05, San Diego County, California",1564,101,613,112,951,136
6073003001,"Census Tract 30.01, San Diego County, California",1187,72,830,89,357,85
6073003003,"Census Tract 30.03, San Diego County, California",1510,94,1216,131,294,99
6073003004,"Census Tract 30.04, San Diego County, California",1230,86,570,106,660,111
6073003101,"Census Tract 31.01, San Diego County, California",1015,81,880,93,135,69
6073003103,"Census Tract 31.03, San Diego County, California",1592,82,1218,113,374,109
6073003105,"Census Tract 31.05, San Diego County, California",947,88,779,104,168,68
6073003107,"Census Tract 31.07, San Diego County, California",1560,73,1214,130,346,116
6073003108,"Census Tract 31.08, San Diego County, California",1053,61,710,120,343,93
6073003109,"Census Tract 31.09, San Diego County, California",846,27,642,85,204,81
6073003111,"Census Tract 31.11, San Diego County, California",1679,68,590,116,1089,132
6073003112,"Census Tract 31.12, San Diego County, California",1252,62,825,98,427,106
6073003113,"Census Tract 31.13, San Diego County, California",1192,98,939,136,253,105
6073003114,"Census Tract 31.14, San Diego County, California",799,37,703,106,96,98
6073003115,"Census Tract 31.15, San Diego County, California",1641,94,1041,102,600,102
6073003201,"Census Tract 32.01, San Diego County, California",1209,119,476,103,733,109
6073003202,"Census Tract 32.02, San Diego County, California",1359,80,875,95,484,106
6073003204,"Census Tract 32.04, San Diego County, California",987,81,837,91,150,77
6073003207,"Census Tract 32.07, San Diego County, California",2038,102,1204,149,834,145
6073003208,"Census Tract 32.08, San Diego County, California",2280,114,1327,163,953,169
6073003209,"Census Tract 32.09, San Diego County, California",1544,139,704,139,840,162
6073003211,"Census Tract 32.11, San Diego County, California",909,25,758,80,151,67
6073003212,"Census Tract 32.12, San Diego County, California",1152,33,999,92,153,91
6073003213,"Census Tract 32.13, San Diego County, California",1109,49,813,130,296,120
6073003214,"Census Tract 32.14, San Diego County, California",1356,88,1008,101,348,98
6073003301,"Census Tract 33.01, San Diego County, California",947,66,417,120,530,123
6073003302,"Census Tract 33.02, San Diego County, California",2562,139,981,170,1581,162
6073003303,"Census Tract 33.03, San Diego County, California",1136,68,247,86,889,108
6073003401,"Census Tract 34.01, San Diego County, California",1781,144,1053,153,728,163
6073003403,"Census Tract 34.03, San Diego County, California",1017,71,545,105,472,109
6073003404,"Census Tract 34.04, San Diego County, California",1093,101,449,99,644,123
6073003501,"Census Tract 35.01, San Diego County, California",1041,70,407,94,634,103
6073003502,"Census Tract 35.02, San Diego County, California",1227,80,462,111,765,110
6073003601,"Census Tract 36.01, San Diego County, California",704,79,228,82,476,100
6073003602,"Census Tract 36.02, San Diego County, California",774,20,303,82,471,78
6073003603,"Census Tract 36.03, San Diego County, California",1056,57,345,93,711,99
6073003800,"Census Tract 38, San Diego County, California",0,132,0,132,0,132
6073003901,"Census Tract 39.01, San Diego County, California",968,73,314,95,654,114
6073003902,"Census Tract 39.02, San Diego County, California",1174,92,289,76,885,110
6073004000,"Census Tract 40, San Diego County, California",1176,96,457,111,719,137
6073004100,"Census Tract 41, San Diego County, California",1863,116,438,85,1425,146
6073004200,"Census Tract 42, San Diego County, California",2379,144,1499,154,880,164
6073004300,"Census Tract 43, San Diego County, California",1744,102,735,128,1009,156
6073004400,"Census Tract 44, San Diego County, California",1762,122,672,133,1090,150
6073004501,"Census Tract 45.01, San Diego County, California",1303,112,295,73,1008,129
6073004502,"Census Tract 45.02, San Diego County, California",716,70,153,72,563,93
6073004600,"Census Tract 46, San Diego County, California",1020,120,48,31,972,115
6073004700,"Census Tract 47, San Diego County, California",643,76,86,37,557,84
6073004800,"Census Tract 48, San Diego County, California",1051,92,275,80,776,116
6073004900,"Census Tract 49, San Diego County, California",1347,77,435,111,912,112
6073005000,"Census Tract 50, San Diego County, California",627,62,65,46,562,73
6073005100,"Census Tract 51, San Diego County, California",2122,138,385,114,1737,164
6073005200,"Census Tract 52, San Diego County, California",1823,140,156,66,1667,145
6073005300,"Census Tract 53, San Diego County, California",2640,179,426,111,2214,197
6073005400,"Census Tract 54, San Diego County, California",4061,295,1485,246,2576,299
6073005500,"Census Tract 55, San Diego County, California",0,132,0,132,0,132
6073005600,"Census Tract 56, San Diego County, California",2234,187,715,157,1519,196
6073005700,"Census Tract 57, San Diego County, California",909,61,65,38,844,71
6073005800,"Census Tract 58, San Diego County, California",1574,144,374,94,1200,139
6073005900,"Census Tract 59, San Diego County, California",1653,111,284,75,1369,120
6073006000,"Census Tract 60, San Diego County, California",1947,138,774,130,1173,172
6073006100,"Census Tract 61, San Diego County, California",1223,72,459,96,764,127
6073006200,"Census Tract 62, San Diego County, California",11,17,0,132,11,17
6073006300,"Census Tract 63, San Diego County, California",0,132,0,132,0,132
6073006400,"Census Tract 64, San Diego County, California",786,63,223,53,563,84
6073006500,"Census Tract 65, San Diego County, California",1372,102,234,90,1138,124
6073006600,"Census Tract 66, San Diego County, California",347,63,0,132,347,63
6073006801,"Census Tract 68.01, San Diego County, California",1474,37,633,134,841,134
6073006802,"Census Tract 68.02, San Diego County, California",2265,119,565,129,1700,171
6073006900,"Census Tract 69, San Diego County, California",2229,86,1551,171,678,155
6073007001,"Census Tract 70.01, San Diego County, California",1876,146,631,94,1245,147
6073007002,"Census Tract 70.02, San Diego County, California",1319,31,1143,74,176,69
6073007100,"Census Tract 71, San Diego County, California",2201,162,1658,166,543,148
6073007200,"Census Tract 72, San Diego County, California",1546,146,1405,138,141,63
6073007301,"Census Tract 73.01, San Diego County, California",2945,127,487,131,2458,184
6073007302,"Census Tract 73.02, San Diego County, California",843,56,716,88,127,73
6073007400,"Census Tract 74, San Diego County, California",3125,133,1242,162,1883,201
6073007501,"Census Tract 75.01, San Diego County, California",2180,156,439,136,1741,188
6073007502,"Census Tract 75.02, San Diego County, California",1707,118,231,98,1476,153
6073007600,"Census Tract 76, San Diego County, California",2959,230,1157,199,1802,228
6073007700,"Census Tract 77, San Diego County, California",4819,207,1085,163,3734,242
6073007800,"Census Tract 78, San Diego County, California",2529,142,576,116,1953,164
6073007901,"Census Tract 79.01, San Diego County, California",2903,187,511,127,2392,202
6073007903,"Census Tract 79.03, San Diego County, California",2700,183,750,172,1950,229
6073007904,"Census Tract 79.04, San Diego County, California",2902,235,486,155,2416,259
6073008001,"Census Tract 80.01, San Diego County, California",3605,211,1242,185,2363,232
6073008002,"Census Tract 80.02, San Diego County, California",1053,47,747,81,306,80
6073008101,"Census Tract 81.01, San Diego County, California",1859,220,690,152,1169,225
6073008102,"Census Tract 81.02, San Diego County, California",1450,83,1116,104,334,92
6073008200,"Census Tract 82, San Diego County, California",1690,188,727,134,963,177
6073008301,"Census Tract 83.01, San Diego County, California",1352,60,1073,85,279,89
6073008303,"Census Tract 83.03, San Diego County, California",1581,123,1264,100,317,148
6073008305,"Census Tract 83.05, San Diego County, California",788,41,88,52,700,65
6073008306,"Census Tract 83.06, San Diego County, California",1232,24,1130,47,102,45
6073008307,"Census Tract 83.07, San Diego County, California",1527,81,1309,91,218,76
6073008310,"Census Tract 83.10, San Diego County, California",2389,108,2197,108,192,86
6073008311,"Census Tract 83.11, San Diego County, California",1043,87,967,92,76,55
6073008312,"Census Tract 83.12, San Diego County, California",1631,133,1114,111,517,115
6073008313,"Census Tract 83.13, San Diego County, California",876,67,761,81,115,56
6073008315,"Census Tract 83.15, San Diego County, California",2785,173,1207,189,1578,189
6073008324,"Census Tract 83.24, San Diego County, California",2910,143,2253,142,657,153
6073008327,"Census Tract 83.27, San Diego County, California",2413,114,1700,152,713,156
6073008328,"Census Tract 83.28, San Diego County, California",1199,90,1070,87,129,76
6073008329,"Census Tract 83.29, San Diego County, California",2935,153,1555,230,1380,225
6073008330,"Census Tract 83.30, San Diego County, California",2078,103,1425,135,653,117
6073008331,"Census Tract 83.31, San Diego County, California",905,24,804,64,101,64
6073008332,"Census Tract 83.32, San Diego County, California",1190,56,1105,67,85,50
6073008333,"Census Tract 83.33, San Diego County, California",4232,208,2365,191,1867,261
6073008334,"Census Tract 83.34, San Diego County, California",1599,91,1224,134,375,109
6073008335,"Census Tract 83.35, San Diego County, California",2931,116,2572,144,359,120
6073008336,"Census Tract 83.36, San Diego County, California",768,14,756,22,12,19
6073008337,"Census Tract 83.37, San Diego County, California",1348,68,1126,94,222,82
6073008338,"Census Tract 83.38, San Diego County, California",3003,86,2799,111,204,96
6073008339,"Census Tract 83.39, San Diego County, California",929,91,139,66,790,110
6073008340,"Census Tract 83.40, San Diego County, California",4324,149,1169,145,3155,190
6073008341,"Census Tract 83.41, San Diego County, California",3171,224,546,124,2625,218
6073008342,"Census Tract 83.42, San Diego County, California",4524,214,1200,201,3324,250
6073008343,"Census Tract 83.43, San Diego County, California",1718,105,403,90,1315,124
6073008344,"Census Tract 83.44, San Diego County, California",1338,33,988,77,350,66
6073008345,"Census Tract 83.45, San Diego County, California",1594,74,912,92,682,104
6073008346,"Census Tract 83.46, San Diego County, California",1622,58,1416,100,206,90
6073008347,"Census Tract 83.47, San Diego County, California",2002,70,1461,141,541,136
6073008348,"Census Tract 83.48, San Diego County, California",1767,50,1247,121,520,116
6073008349,"Census Tract 83.49, San Diego County, California",1063,53,758,74,305,74
6073008350,"Census Tract 83.50, San Diego County, California",2132,127,1038,128,1094,159
6073008351,"Census Tract 83.51, San Diego County, California",1300,79,743,97,557,94
6073008352,"Census Tract 83.52, San Diego County, California",1070,66,557,86,513,100
6073008353,"Census Tract 83.53, San Diego County, California",1538,99,1202,130,336,92
6073008354,"Census Tract 83.54, San Diego County, California",2029,119,1028,163,1001,185
6073008355,"Census Tract 83.55, San Diego County, California",921,63,688,92,233,81
6073008356,"Census Tract 83.56, San Diego County, California",1333,79,849,117,484,113
6073008357,"Census Tract 83.57, San Diego County, California",1565,60,935,123,630,128
6073008358,"Census Tract 83.58, San Diego County, California",2136,114,1138,202,998,177
6073008359,"Census Tract 83.59, San Diego County, California",1616,92,252,95,1364,126
6073008360,"Census Tract 83.60, San Diego County, California",2102,145,1304,162,798,202
6073008501,"Census Tract 85.01, San Diego County, California",2252,87,1670,170,582,172
6073008502,"Census Tract 85.02, San Diego County, California",2366,88,1660,154,706,172
6073008503,"Census Tract 85.03, San Diego County, California",2900,130,1861,175,1039,191
6073008504,"Census Tract 85.04, San Diego County, California",2340,101,1593,146,747,150
6073008505,"Census Tract 85.05, San Diego County, California",2170,78,1456,184,714,177
6073008506,"Census Tract 85.06, San Diego County, California",1578,23,1064,105,514,103
6073008507,"Census Tract 85.07, San Diego County, California",2725,134,1434,143,1291,165
6073008509,"Census Tract 85.09, San Diego County, California",2755,112,1726,227,1029,203
6073008510,"Census Tract 85.10, San Diego County, California",2771,140,1286,167,1485,196
6073008511,"Census Tract 85.11, San Diego County, California",1091,133,678,123,413,117
6073008512,"Census Tract 85.12, San Diego County, California",1665,59,1329,120,336,101
6073008513,"Census Tract 85.13, San Diego County, California",1167,24,1004,75,163,71
6073008600,"Census Tract 86, San Diego County, California",1763,148,739,134,1024,149
6073008701,"Census Tract 87.01, San Diego County, California",1283,55,181,53,1102,74
6073008702,"Census Tract 87.02, San Diego County, California",1628,118,756,129,872,136
6073008800,"Census Tract 88, San Diego County, California",1938,99,674,121,1264,157
6073008901,"Census Tract 89.01, San Diego County, California",2128,165,1167,195,961,150
6073008902,"Census Tract 89.02, San Diego County, California",1251,131,792,137,459,129
6073009000,"Census Tract 90, San Diego County, California",1347,50,573,109,774,113
6073009101,"Census Tract 91.01, San Diego County, California",2429,87,1502,134,927,132
6073009102,"Census Tract 91.02, San Diego County, California",1759,76,317,80,1442,97
6073009103,"Census Tract 91.03, San Diego County, California",1586,90,1137,94,449,97
6073009104,"Census Tract 91.04, San Diego County, California",1167,54,1015,68,152,54
6073009106,"Census Tract 91.06, San Diego County, California",1157,113,668,84,489,120
6073009107,"Census Tract 91.07, San Diego County, California",1857,77,763,138,1094,146
6073009201,"Census Tract 92.01, San Diego County, California",1366,161,579,74,787,161
6073009202,"Census Tract 92.02, San Diego County, California",1821,82,1231,104,590,99
6073009301,"Census Tract 93.01, San Diego County, California",1679,105,984,126,695,141
6073009303,"Census Tract 93.03, San Diego County, California",4407,189,2264,194,2143,251
6073009304,"Census Tract 93.04, San Diego County, California",3707,255,997,183,2710,270
6073009400,"Census Tract 94, San Diego County, California",463,65,7,11,456,66
6073009502,"Census Tract 95.02, San Diego County, California",1828,75,1063,119,765,100
6073009504,"Census Tract 95.04, San Diego County, California",1532,106,1298,107,234,95
6073009505,"Census Tract 95.05, San Diego County, California",2861,60,1815,191,1046,187
6073009506,"Census Tract 95.06, San Diego County, California",1690,41,1225,116,465,115
6073009507,"Census Tract 95.07, San Diego County, California",1848,40,888,69,960,68
6073009508,"Census Tract 95.08, San Diego County, California",2344,104,0,132,2344,104
6073009509,"Census Tract 95.09, San Diego County, California",1955,155,628,119,1327,179
6073009602,"Census Tract 96.02, San Diego County, California",1837,28,1347,115,490,114
6073009603,"Census Tract 96.03, San Diego County, California",2639,123,911,152,1728,165
6073009604,"Census Tract 96.04, San Diego County, California",1431,54,804,100,627,106
6073009703,"Census Tract 97.03, San Diego County, California",1389,58,997,95,392,92
6073009704,"Census Tract 97.04, San Diego County, California",2392,103,1914,166,478,135
6073009705,"Census Tract 97.05, San Diego County, California",1426,65,1076,132,350,114
6073009706,"Census Tract 97.06, San Diego County, California",2992,108,2514,152,478,156
6073009801,"Census Tract 98.01, San Diego County, California",2296,113,1523,169,773,165
6073009802,"Census Tract 98.02, San Diego County, California",2472,88,1595,190,877,177
6073009804,"Census Tract 98.04, San Diego County, California",1841,64,1682,92,159,71
6073009805,"Census Tract 98.05, San Diego County, California",1971,121,1592,137,379,116
6073009901,"Census Tract 99.01, San Diego County, California",8,14,0,132,8,14
6073009902,"Census Tract 99.02, San Diego County, California",0,132,0,132,0,132
6073010001,"Census Tract 100.01, San Diego County, California",1108,62,761,116,347,116
6073010003,"Census Tract 100.03, San Diego County, California",1433,102,1216,111,217,95
6073010004,"Census Tract 100.04, San Diego County, California",1050,89,859,122,191,92
6073010005,"Census Tract 100.05, San Diego County, California",1972,73,764,112,1208,117
6073010009,"Census Tract 100.09, San Diego County, California",1562,106,745,128,817,135
6073010010,"Census Tract 100.10, San Diego County, California",1771,82,1200,162,571,141
6073010011,"Census Tract 100.11, San Diego County, California",900,80,726,104,174,75
6073010012,"Census Tract 100.12, San Diego County, California",1283,54,462,94,821,98
6073010013,"Census Tract 100.13, San Diego County, California",1396,120,96,63,1300,134
6073010014,"Census Tract 100.14, San Diego County, California",3197,118,2232,192,965,177
6073010015,"Census Tract 100.15, San Diego County, California",541,62,416,61,125,72
6073010103,"Census Tract 101.03, San Diego County, California",1716,87,949,125,767,129
6073010104,"Census Tract 101.04, San Diego County, California",1054,77,849,100,205,107
6073010106,"Census Tract 101.06, San Diego County, California",1622,29,967,132,655,124
6073010107,"Census Tract 101.07, San Diego County, California",1653,106,983,135,670,130
6073010109,"Census Tract 101.09, San Diego County, California",1206,62,744,102,462,98
6073010110,"Census Tract 101.10, San Diego County, California",2055,111,1044,142,1011,135
6073010111,"Census Tract 101.11, San Diego County, California",827,65,367,93,460,92
6073010112,"Census Tract 101.12, San Diego County, California",1533,69,160,63,1373,77
6073010200,"Census Tract 102, San Diego County, California",2595,194,1039,147,1556,207
6073010300,"Census Tract 103, San Diego County, California",1533,132,841,137,692,131
6073010401,"Census Tract 104.01, San Diego County, California",771,109,184,76,587,95
6073010402,"Census Tract 104.02, San Diego County, California",1834,135,435,121,1399,154
6073010501,"Census Tract 105.01, San Diego County, California",637,36,304,105,333,119
6073010502,"Census Tract 105.02, San Diego County, California",1945,122,235,73,1710,130
6073010601,"Census Tract 106.01, San Diego County, California",964,147,695,137,269,93
6073010602,"Census Tract 106.02, San Diego County, California",354,81,0,132,354,81
6073010603,"Census Tract 106.03, San Diego County, California",548,113,467,107,81,52
6073010700,"Census Tract 107, San Diego County, California",579,99,239,56,340,98
6073010800,"Census Tract 108, San Diego County, California",1148,158,569,111,579,140
6073010900,"Census Tract 109, San Diego County, California",809,121,520,112,289,105
6073011000,"Census Tract 110, San Diego County, California",1478,171,511,112,967,144
6073011100,"Census Tract 111, San Diego County, California",1672,194,703,136,969,179
6073011200,"Census Tract 112, San Diego County, California",467,47,375,54,92,41
6073011300,"Census Tract 113, San Diego County, California",20,22,0,132,20,22
6073011400,"Census Tract 114, San Diego County, California",457,64,112,66,345,96
6073011500,"Census Tract 115, San Diego County, California",60,23,31,36,29,27
6073011601,"Census Tract 116.01, San Diego County, California",1719,94,201,83,1518,123
6073011602,"Census Tract 116.02, San Diego County, California",964,91,324,102,640,114
6073011700,"Census Tract 117, San Diego County, California",2164,126,428,138,1736,169
6073011801,"Census Tract 118.01, San Diego County, California",977,97,278,89,699,118
6073011802,"Census Tract 118.02, San Diego County, California",1555,136,419,97,1136,150
6073011901,"Census Tract 119.01, San Diego County, California",395,54,76,47,319,65
6073011902,"Census Tract 119.02, San Diego County, California",1278,87,1085,119,193,78
6073012001,"Census Tract 120.01, San Diego County, California",651,59,99,53,552,67
6073012002,"Census Tract 120.02, San Diego County, California",1041,135,163,46,878,144
6073012003,"Census Tract 120.03, San Diego County, California",783,71,534,98,249,80
6073012101,"Census Tract 121.01, San Diego County, California",608,59,326,83,282,91
6073012102,"Census Tract 121.02, San Diego County, California",885,92,534,128,351,126
6073012200,"Census Tract 122, San Diego County, California",855,32,413,109,442,107
6073012302,"Census Tract 123.02, San Diego County, California",635,84,168,66,467,101
6073012303,"Census Tract 123.03, San Diego County, California",1297,115,500,94,797,148
6073012304,"Census Tract 123.04, San Diego County, California",1210,97,674,103,536,101
6073012401,"Census Tract 124.01, San Diego County, California",1149,99,407,101,742,116
6073012402,"Census Tract 124.02, San Diego County, California",1715,119,386,94,1329,141
6073012500,"Census Tract 125, San Diego County, California",2708,168,940,181,1768,230
6073012600,"Census Tract 126, San Diego County, California",1439,106,664,111,775,123
6073012700,"Census Tract 127, San Diego County, California",1777,78,396,113,1381,139
6073012800,"Census Tract 128, San Diego County, California",1306,85,623,112,683,139
6073012900,"Census Tract 129, San Diego County, California",1008,85,809,95,199,93
6073013000,"Census Tract 130, San Diego County, California",1814,76,850,136,964,133
6073013102,"Census Tract 131.02, San Diego County, California",1798,188,462,132,1336,175
6073013103,"Census Tract 131.03, San Diego County, California",677,56,351,71,326,67
6073013104,"Census Tract 131.04, San Diego County, California",1775,98,406,86,1369,128
6073013203,"Census Tract 132.03, San Diego County, California",2066,87,400,114,1666,135
6073013204,"Census Tract 132.04, San Diego County, California",1065,63,579,143,486,142
6073013205,"Census Tract 132.05, San Diego County, California",917,51,270,69,647,74
6073013206,"Census Tract 132.06, San Diego County, California",2080,117,757,136,1323,145
6073013301,"Census Tract 133.01, San Diego County, California",1444,78,1184,124,260,94
6073013302,"Census Tract 133.02, San Diego County, California",1267,56,1125,86,142,66
6073013303,"Census Tract 133.03, San Diego County, California",1402,61,1024,135,378,125
6073013306,"Census Tract 133.06, San Diego County, California",1175,77,828,125,347,108
6073013307,"Census Tract 133.07, San Diego County, California",959,67,671,106,288,104
6073013308,"Census Tract 133.08, San Diego County, California",869,79,533,123,336,99
6073013309,"Census Tract 133.09, San Diego County, California",1875,86,1537,134,338,120
6073013310,"Census Tract 133.10, San Diego County, California",7135,280,4679,280,2456,287
6073013311,"Census Tract 133.11, San Diego County, California",2474,140,1833,198,641,182
6073013312,"Census Tract 133.12, San Diego County, California",692,85,535,97,157,72
6073013313,"Census Tract 133.13, San Diego County, California",4559,260,3664,282,895,232
6073013401,"Census Tract 134.01, San Diego County, California",1345,68,1132,92,213,94
6073013409,"Census Tract 134.09, San Diego County, California",1691,89,1077,99,614,126
6073013410,"Census Tract 134.10, San Diego County, California",1959,115,1752,143,207,97
6073013411,"Census Tract 134.11, San Diego County, California",1622,46,1423,134,199,138
6073013412,"Census Tract 134.12, San Diego County, California",1543,103,1209,138,334,109
6073013413,"Census Tract 134.13, San Diego County, California",2189,151,1605,184,584,161
6073013414,"Census Tract 134.14, San Diego County, California",1930,149,1572,181,358,155
6073013415,"Census Tract 134.15, San Diego County, California",437,67,381,60,56,41
6073013416,"Census Tract 134.16, San Diego County, California",1124,74,957,81,167,69
6073013417,"Census Tract 134.17, San Diego County, California",580,41,512,62,68,42
6073013418,"Census Tract 134.18, San Diego County, California",1914,109,1412,185,502,150
6073013419,"Census Tract 134.19, San Diego County, California",2029,116,1748,154,281,103
6073013503,"Census Tract 135.03, San Diego County, California",1690,145,1063,174,627,144
6073013504,"Census Tract 135.04, San Diego County, California",1110,43,915,86,195,85
6073013505,"Census Tract 135.05, San Diego County, California",1809,71,1228,103,581,94
6073013506,"Census Tract 135.06, San Diego County, California",906,87,706,81,200,105
6073013601,"Census Tract 136.01, San Diego County, California",1866,70,1403,144,463,130
6073013604,"Census Tract 136.04, San Diego County, California",2086,94,1301,114,785,130
6073013605,"Census Tract 136.05, San Diego County, California",1990,105,1769,158,221,105
6073013606,"Census Tract 136.06, San Diego County, California",2205,136,1397,163,808,184
6073013701,"Census Tract 137.01, San Diego County, California",833,46,720,60,113,44
6073013702,"Census Tract 137.02, San Diego County, California",1552,98,841,117,711,116
6073013801,"Census Tract 138.01, San Diego County, California",1668,71,988,96,680,101
6073013802,"Census Tract 138.02, San Diego County, California",825,72,352,113,473,102
6073013903,"Census Tract 139.03, San Diego County, California",1228,37,853,103,375,105
6073013905,"Census Tract 139.05, San Diego County, California",1042,78,914,92,128,67
6073013906,"Census Tract 139.06, San Diego County, California",1560,55,752,107,808,110
6073013907,"Census Tract 139.07, San Diego County, California",1182,81,407,86,775,110
6073013908,"Census Tract 139.08, San Diego County, California",1037,64,524,82,513,91
6073013909,"Census Tract 139.09, San Diego County, California",1249,44,1082,90,167,78
6073014001,"Census Tract 140.01, San Diego County, California",1512,110,959,159,553,138
6073014002,"Census Tract 140.02, San Diego County, California",1148,76,989,87,159,72
6073014101,"Census Tract 141.01, San Diego County, California",1232,73,978,110,254,90
6073014102,"Census Tract 141.02, San Diego County, California",1131,63,890,96,241,89
6073014200,"Census Tract 142, San Diego County, California",2023,103,1563,135,460,108
6073014300,"Census Tract 143, San Diego County, California",1241,100,679,77,562,95
6073014400,"Census Tract 144, San Diego County, California",1441,119,162,79,1279,123
6073014500,"Census Tract 145, San Diego County, California",1351,73,614,92,737,88
6073014601,"Census Tract 146.01, San Diego County, California",1960,132,949,183,1011,193
6073014602,"Census Tract 146.02, San Diego County, California",1658,73,1104,108,554,124
6073014700,"Census Tract 147, San Diego County, California",2904,151,1864,168,1040,172
6073014801,"Census Tract 148.01, San Diego County, California",2933,180,1046,160,1887,200
6073014803,"Census Tract 148.03, San Diego County, California",2256,146,516,137,1740,196
6073014804,"Census Tract 148.04, San Diego County, California",2091,111,1262,148,829,151
6073014900,"Census Tract 149, San Diego County, California",3063,186,1338,179,1725,197
6073015000,"Census Tract 150, San Diego County, California",2067,148,1005,156,1062,151
6073015100,"Census Tract 151, San Diego County, California",1893,95,1187,130,706,120
6073015200,"Census Tract 152, San Diego County, California",1328,89,1249,95,79,52
6073015301,"Census Tract 153.01, San Diego County, California",941,84,489,103,452,111
6073015302,"Census Tract 153.02, San Diego County, California",1356,62,1177,77,179,61
6073015403,"Census Tract 154.03, San Diego County, California",862,45,798,59,64,44
6073015404,"Census Tract 154.04, San Diego County, California",2470,112,1076,165,1394,186
6073015405,"Census Tract 154.05, San Diego County, California",1871,66,1494,109,377,111
6073015406,"Census Tract 154.06, San Diego County, California",837,26,763,51,74,45
6073015501,"Census Tract 155.01, San Diego County, California",1559,112,1385,126,174,76
6073015502,"Census Tract 155.02, San Diego County, California",909,81,846,91,63,45
6073015601,"Census Tract 156.01, San Diego County, California",1777,110,1136,99,641,116
6073015602,"Census Tract 156.02, San Diego County, California",710,57,665,63,45,46
6073015701,"Census Tract 157.01, San Diego County, California",1917,147,387,101,1530,154
6073015703,"Census Tract 157.03, San Diego County, California",1973,207,419,117,1554,182
6073015704,"Census Tract 157.04, San Diego County, California",1303,111,597,114,706,107
6073015801,"Census Tract 158.01, San Diego County, California",1148,104,148,69,1000,118
6073015802,"Census Tract 158.02, San Diego County, California",1329,108,340,99,989,146
6073015901,"Census Tract 159.01, San Diego County, California",882,80,42,36,840,85
6073015902,"Census Tract 159.02, San Diego County, California",1655,95,751,163,904,149
6073016000,"Census Tract 160, San Diego County, California",856,55,578,63,278,72
6073016100,"Census Tract 161, San Diego County, California",2116,80,1342,146,774,122
6073016201,"Census Tract 162.01, San Diego County, California",2116,63,1623,131,493,138
6073016202,"Census Tract 162.02, San Diego County, California",1214,107,244,71,970,100
6073016301,"Census Tract 163.01, San Diego County, California",1564,89,519,95,1045,104
6073016302,"Census Tract 163.02, San Diego County, California",1504,110,580,118,924,124
6073016401,"Census Tract 164.01, San Diego County, California",1537,81,1218,110,319,107
6073016402,"Census Tract 164.02, San Diego County, California",2092,204,925,151,1167,175
6073016501,"Census Tract 165.01, San Diego County, California",3114,159,1431,169,1683,169
6073016502,"Census Tract 165.02, San Diego County, California",1999,142,578,122,1421,180
6073016605,"Census Tract 166.05, San Diego County, California",3020,152,2360,200,660,154
6073016606,"Census Tract 166.06, San Diego County, California",1068,61,773,84,295,81
6073016607,"Census Tract 166.07, San Diego County, California",2208,123,1783,141,425,125
6073016608,"Census Tract 166.08, San Diego County, California",804,21,750,38,54,34
6073016609,"Census Tract 166.09, San Diego County, California",1730,73,1325,130,405,127
6073016610,"Census Tract 166.10, San Diego County, California",1428,64,982,113,446,108
6073016612,"Census Tract 166.12, San Diego County, California",1892,84,1523,133,369,114
6073016613,"Census Tract 166.13, San Diego County, California",719,38,513,59,206,66
6073016614,"Census Tract 166.14, San Diego County, California",1302,74,1028,101,274,78
6073016615,"Census Tract 166.15, San Diego County, California",672,82,378,73,294,82
6073016616,"Census Tract 166.16, San Diego County, California",1350,88,725,97,625,92
6073016617,"Census Tract 166.17, San Diego County, California",1428,117,858,118,570,136
6073016701,"Census Tract 167.01, San Diego County, California",2832,88,1581,224,1251,237
6073016702,"Census Tract 167.02, San Diego County, California",2579,159,1127,205,1452,222
6073016802,"Census Tract 168.02, San Diego County, California",2712,119,2390,144,322,136
6073016804,"Census Tract 168.04, San Diego County, California",2474,160,956,178,1518,211
6073016806,"Census Tract 168.06, San Diego County, California",1483,46,763,108,720,104
6073016807,"Census Tract 168.07, San Diego County, California",2431,110,2048,113,383,106
6073016809,"Census Tract 168.09, San Diego County, California",1777,138,1643,134,134,79
6073016810,"Census Tract 168.10, San Diego County, California",914,17,789,75,125,70
6073016811,"Census Tract 168.11, San Diego County, California",1548,101,1341,94,207,80
6073016901,"Census Tract 169.01, San Diego County, California",2305,112,1764,126,541,161
6073016902,"Census Tract 169.02, San Diego County, California",630,71,497,79,133,72
6073017006,"Census Tract 170.06, San Diego County, California",1052,41,967,64,85,47
6073017007,"Census Tract 170.07, San Diego County, California",2881,130,2518,126,363,87
6073017009,"Census Tract 170.09, San Diego County, California",1354,104,898,96,456,117
6073017010,"Census Tract 170.10, San Diego County, California",986,52,914,62,72,39
6073017014,"Census Tract 170.14, San Diego County, California",1609,105,1059,105,550,93
6073017015,"Census Tract 170.15, San Diego County, California",3071,175,2463,191,608,144
6073017018,"Census Tract 170.18, San Diego County, California",1734,65,877,133,857,139
6073017019,"Census Tract 170.19, San Diego County, California",3051,147,2641,183,410,122
6073017020,"Census Tract 170.20, San Diego County, California",1341,78,1200,87,141,69
6073017021,"Census Tract 170.21, San Diego County, California",1008,62,932,87,76,57
6073017022,"Census Tract 170.22, San Diego County, California",2244,81,1820,137,424,129
6073017026,"Census Tract 170.26, San Diego County, California",4046,194,2815,234,1231,227
6073017029,"Census Tract 170.29, San Diego County, California",2430,140,2180,143,250,102
6073017030,"Census Tract 170.30, San Diego County, California",4504,165,2980,204,1524,234
6073017031,"Census Tract 170.31, San Diego County, California",1336,94,1036,118,300,105
6073017032,"Census Tract 170.32, San Diego County, California",3966,117,2842,185,1124,174
6073017033,"Census Tract 170.33, San Diego County, California",1591,50,1201,112,390,107
6073017034,"Census Tract 170.34, San Diego County, California",1660,89,941,95,719,90
6073017035,"Census Tract 170.35, San Diego County, California",1078,60,381,75,697,87
6073017036,"Census Tract 170.36, San Diego County, California",1257,19,819,117,438,114
6073017037,"Census Tract 170.37, San Diego County, California",2159,50,1548,139,611,143
6073017038,"Census Tract 170.38, San Diego County, California",3499,201,1898,168,1601,196
6073017039,"Census Tract 170.39, San Diego County, California",2522,110,2010,159,512,146
6073017040,"Census Tract 170.40, San Diego County, California",1410,54,1223,70,187,62
6073017041,"Census Tract 170.41, San Diego County, California",2137,73,1474,138,663,122
6073017042,"Census Tract 170.42, San Diego County, California",2661,117,1965,151,696,148
6073017043,"Census Tract 170.43, San Diego County, California",2054,79,1584,145,470,127
6073017044,"Census Tract 170.44, San Diego County, California",1910,31,1738,81,172,81
6073017045,"Census Tract 170.45, San Diego County, California",859,45,844,48,15,17
6073017046,"Census Tract 170.46, San Diego County, California",1516,22,1411,59,105,57
6073017047,"Census Tract 170.47, San Diego County, California",1418,54,1322,77,96,60
6073017048,"Census Tract 170.48, San Diego County, California",2306,110,1151,150,1155,181
6073017049,"Census Tract 170.49, San Diego County, California",919,42,642,72,277,72
6073017050,"Census Tract 170.50, San Diego County, California",1042,64,606,88,436,92
6073017104,"Census Tract 171.04, San Diego County, California",1497,63,1145,88,352,103
6073017105,"Census Tract 171.05, San Diego County, California",4498,137,3523,171,975,151
6073017106,"Census Tract 171.06, San Diego County, California",1496,117,1327,127,169,91
6073017107,"Census Tract 171.07, San Diego County, California",898,55,876,50,22,32
6073017108,"Census Tract 171.08, San Diego County, California",1714,59,1327,136,387,120
6073017200,"Census Tract 172, San Diego County, California",2175,137,1289,233,886,210
6073017303,"Census Tract 173.03, San Diego County, California",1256,80,820,106,436,95
6073017304,"Census Tract 173.04, San Diego County, California",2435,178,1020,165,1415,220
6073017305,"Census Tract 173.05, San Diego County, California",1295,78,1097,116,198,90
6073017306,"Census Tract 173.06, San Diego County, California",1204,76,1085,88,119,73
6073017401,"Census Tract 174.01, San Diego County, California",2534,144,1165,161,1369,181
6073017403,"Census Tract 174.03, San Diego County, California",2000,91,1685,121,315,98
6073017404,"Census Tract 174.04, San Diego County, California",2514,70,1798,166,716,155
6073017501,"Census Tract 175.01, San Diego County, California",1222,112,590,96,632,97
6073017502,"Census Tract 175.02, San Diego County, California",1257,52,567,111,690,109
6073017601,"Census Tract 176.01, San Diego County, California",1729,93,1274,116,455,99
6073017603,"Census Tract 176.03, San Diego County, California",907,60,742,60,165,48
6073017604,"Census Tract 176.04, San Diego County, California",2868,182,1565,149,1303,177
6073017701,"Census Tract 177.01, San Diego County, California",2127,193,1025,142,1102,221
6073017702,"Census Tract 177.02, San Diego County, California",1288,117,660,98,628,117
6073017801,"Census Tract 178.01, San Diego County, California",2487,117,1412,159,1075,142
6073017805,"Census Tract 178.05, San Diego County, California",1646,98,1375,123,271,91
6073017806,"Census Tract 178.06, San Diego County, California",933,78,529,80,404,90
6073017808,"Census Tract 178.08, San Diego County, California",2205,90,1906,136,299,101
6073017809,"Census Tract 178.09, San Diego County, California",882,23,639,79,243,75
6073017810,"Census Tract 178.10, San Diego County, California",1839,101,1424,132,415,104
6073017811,"Census Tract 178.11, San Diego County, California",2555,165,1684,179,871,135
6073017812,"Census Tract 178.12, San Diego County, California",2217,98,1234,142,983,146
6073017900,"Census Tract 179, San Diego County, California",2595,157,643,152,1952,186
6073018000,"Census Tract 180, San Diego County, California",1584,117,226,74,1358,129
6073018100,"Census Tract 181, San Diego County, California",2559,179,1417,211,1142,210
6073018200,"Census Tract 182, San Diego County, California",2473,112,400,105,2073,126
6073018300,"Census Tract 183, San Diego County, California",1563,161,463,118,1100,138
6073018400,"Census Tract 184, San Diego County, California",1266,117,336,97,930,126
6073018504,"Census Tract 185.04, San Diego County, California",2493,123,1412,154,1081,189
6073018507,"Census Tract 185.07, San Diego County, California",3095,139,2273,206,822,163
6073018509,"Census Tract 185.09, San Diego County, California",1653,104,441,99,1212,137
6073018510,"Census Tract 185.10, San Diego County, California",809,72,625,81,184,74
6073018511,"Census Tract 185.11, San Diego County, California",1843,55,954,107,889,114
6073018512,"Census Tract 185.12, San Diego County, California",2214,72,1440,165,774,159
6073018513,"Census Tract 185.13, San Diego County, California",2843,223,1651,204,1192,211
6073018514,"Census Tract 185.14, San Diego County, California",2786,148,1946,186,840,156
6073018515,"Census Tract 185.15, San Diego County, California",1624,113,1185,91,439,93
6073018516,"Census Tract 185.16, San Diego County, California",1270,60,692,113,578,115
6073018517,"Census Tract 185.17, San Diego County, California",1876,92,1080,122,796,128
6073018518,"Census Tract 185.18, San Diego County, California",796,49,491,57,305,68
6073018519,"Census Tract 185.19, San Diego County, California",1367,52,759,83,608,80
6073018601,"Census Tract 186.01, San Diego County, California",1517,81,1112,142,405,132
6073018603,"Census Tract 186.03, San Diego County, California",1973,128,647,128,1326,161
6073018607,"Census Tract 186.07, San Diego County, California",3885,206,2567,255,1318,214
6073018608,"Census Tract 186.08, San Diego County, California",1288,42,1082,94,206,99
6073018609,"Census Tract 186.09, San Diego County, California",1766,110,1300,134,466,119
6073018610,"Census Tract 186.10, San Diego County, California",1919,82,1152,128,767,127
6073018611,"Census Tract 186.11, San Diego County, California",1976,142,1624,208,352,151
6073018612,"Census Tract 186.12, San Diego County, California",1054,67,925,96,129,72
6073018700,"Census Tract 187, San Diego County, California",5596,362,214,211,5382,368
6073018801,"Census Tract 188.01, San Diego County, California",1245,65,1118,93,127,73
6073018802,"Census Tract 188.02, San Diego County, California",3270,113,2877,147,393,129
6073018803,"Census Tract 188.03, San Diego County, California",1662,87,1429,99,233,79
6073018903,"Census Tract 189.03, San Diego County, California",1535,101,982,104,553,131
6073018904,"Census Tract 189.04, San Diego County, California",1703,105,797,99,906,130
6073018905,"Census Tract 189.05, San Diego County, California",1910,90,901,137,1009,137
6073018906,"Census Tract 189.06, San Diego County, California",1909,96,928,124,981,125
6073019001,"Census Tract 190.01, San Diego County, California",2100,110,1922,125,178,81
6073019002,"Census Tract 190.02, San Diego County, California",505,49,343,45,162,48
6073019101,"Census Tract 191.01, San Diego County, California",1951,112,1291,141,660,148
6073019103,"Census Tract 191.03, San Diego County, California",2102,120,1775,167,327,140
6073019105,"Census Tract 191.05, San Diego County, California",2477,105,2337,127,140,64
6073019106,"Census Tract 191.06, San Diego County, California",2118,151,1784,182,334,123
6073019107,"Census Tract 191.07, San Diego County, California",809,34,722,48,87,38
6073019203,"Census Tract 192.03, San Diego County, California",969,51,830,71,139,59
6073019205,"Census Tract 192.05, San Diego County, California",1641,129,985,128,656,132
6073019206,"Census Tract 192.06, San Diego County, California",1301,59,493,98,808,127
6073019207,"Census Tract 192.07, San Diego County, California",2585,142,1502,156,1083,178
6073019208,"Census Tract 192.08, San Diego County, California",955,80,847,90,108,60
6073019301,"Census Tract 193.01, San Diego County, California",2315,57,1926,142,389,130
6073019302,"Census Tract 193.02, San Diego County, California",2842,156,1795,192,1047,199
6073019303,"Census Tract 193.03, San Diego County, California",2174,94,1692,132,482,117
6073019403,"Census Tract 194.03, San Diego County, California",1535,85,1336,116,199,96
6073019404,"Census Tract 194.04, San Diego County, California",804,33,451,95,353,100
6073019405,"Census Tract 194.05, San Diego County, California",1068,74,391,79,677,102
6073019406,"Census Tract 194.06, San Diego County, California",1338,104,900,117,438,116
6073019501,"Census Tract 195.01, San Diego County, California",731,56,235,61,496,86
6073019502,"Census Tract 195.02, San Diego County, California",1238,66,307,96,931,106
6073019503,"Census Tract 195.03, San Diego County, California",1380,89,694,106,686,107
6073019601,"Census Tract 196.01, San Diego County, California",2025,125,1320,162,705,153
6073019602,"Census Tract 196.02, San Diego County, California",1543,83,1025,103,518,103
6073019701,"Census Tract 197.01, San Diego County, California",2161,103,1185,139,976,149
6073019702,"Census Tract 197.02, San Diego County, California",1586,90,1214,108,372,104
6073019803,"Census Tract 198.03, San Diego County, California",1618,77,870,109,748,127
6073019804,"Census Tract 198.04, San Diego County, California",1490,115,1319,121,171,74
6073019805,"Census Tract 198.05, San Diego County, California",1339,131,992,132,347,106
6073019806,"Census Tract 198.06, San Diego County, California",3481,145,2831,174,650,168
6073019807,"Census Tract 198.07, San Diego County, California",4111,119,3341,159,770,125
6073019902,"Census Tract 199.02, San Diego County, California",1390,78,807,87,583,106
6073019903,"Census Tract 199.03, San Diego County, California",1096,92,808,95,288,98
6073019904,"Census Tract 199.04, San Diego County, California",2139,103,1254,142,885,144
6073019905,"Census Tract 199.05, San Diego County, California",2001,80,1015,123,986,126
6073020009,"Census Tract 200.09, San Diego County, California",2667,128,481,160,2186,203
6073020010,"Census Tract 200.10, San Diego County, California",6432,182,5165,287,1267,272
6073020013,"Census Tract 200.13, San Diego County, California",3952,162,3238,169,714,152
6073020014,"Census Tract 200.14, San Diego County, California",2457,142,2036,166,421,125
6073020015,"Census Tract 200.15, San Diego County, California",1591,84,1180,128,411,107
6073020016,"Census Tract 200.16, San Diego County, California",2935,127,2594,175,341,146
6073020017,"Census Tract 200.17, San Diego County, California",1052,85,397,78,655,102
6073020018,"Census Tract 200.18, San Diego County, California",1837,104,1014,120,823,132
6073020019,"Census Tract 200.19, San Diego County, California",2789,101,2477,150,312,122
6073020020,"Census Tract 200.20, San Diego County, California",1904,98,1712,163,192,120
6073020021,"Census Tract 200.21, San Diego County, California",1543,102,602,110,941,134
6073020022,"Census Tract 200.22, San Diego County, California",2396,103,1675,174,721,161
6073020023,"Census Tract 200.23, San Diego County, California",1293,58,1028,109,265,100
6073020024,"Census Tract 200.24, San Diego County, California",1375,83,1146,118,229,91
6073020025,"Census Tract 200.25, San Diego County, California",1765,62,1042,141,723,139
6073020103,"Census Tract 201.03, San Diego County, California",2979,168,2669,187,310,119
6073020105,"Census Tract 201.05, San Diego County, California",1307,79,711,97,596,112
6073020106,"Census Tract 201.06, San Diego County, California",1084,88,794,122,290,122
6073020107,"Census Tract 201.07, San Diego County, California",1138,37,828,73,310,72
6073020108,"Census Tract 201.08, San Diego County, California",1369,92,577,119,792,131
6073020109,"Census Tract 201.09, San Diego County, California",1261,68,963,113,298,97
6073020202,"Census Tract 202.02, San Diego County, California",1735,77,635,155,1100,166
6073020206,"Census Tract 202.06, San Diego County, California",1147,69,473,90,674,94
6073020207,"Census Tract 202.07, San Diego County, California",1391,59,580,107,811,103
6073020208,"Census Tract 202.08, San Diego County, California",641,23,576,57,65,50
6073020209,"Census Tract 202.09, San Diego County, California",1710,109,873,109,837,133
6073020210,"Census Tract 202.10, San Diego County, California",1487,68,834,121,653,114
6073020211,"Census Tract 202.11, San Diego County, California",2155,129,597,162,1558,175
6073020212,"Census Tract 202.12, San Diego County, California",2262,178,187,81,2075,187
6073020302,"Census Tract 203.02, San Diego County, California",3424,194,1264,221,2160,203
6073020304,"Census Tract 203.04, San Diego County, California",2211,109,2021,145,190,100
6073020305,"Census Tract 203.05, San Diego County, California",1925,132,1237,164,688,155
6073020306,"Census Tract 203.06, San Diego County, California",2741,168,1858,211,883,175
6073020307,"Census Tract 203.07, San Diego County, California",2503,155,1855,139,648,147
6073020401,"Census Tract 204.01, San Diego County, California",850,73,784,73,66,57
6073020403,"Census Tract 204.03, San Diego County, California",1199,40,881,110,318,110
6073020404,"Census Tract 204.04, San Diego County, California",1738,133,976,97,762,146
6073020405,"Census Tract 204.05, San Diego County, California",1189,47,1105,59,84,44
6073020500,"Census Tract 205, San Diego County, California",1327,87,568,108,759,111
6073020601,"Census Tract 206.01, San Diego County, California",1224,106,385,90,839,130
6073020602,"Census Tract 206.02, San Diego County, California",1821,90,960,116,861,133
6073020705,"Census Tract 207.05, San Diego County, California",1328,61,1186,86,142,72
6073020706,"Census Tract 207.06, San Diego County, California",1921,110,1881,113,40,44
6073020707,"Census Tract 207.07, San Diego County, California",1348,101,601,102,747,110
6073020708,"Census Tract 207.08, San Diego County, California",1031,85,811,99,220,83
6073020709,"Census Tract 207.09, San Diego County, California",2208,109,2019,120,189,83
6073020710,"Census Tract 207.10, San Diego County, California",595,62,472,98,123,87
6073020801,"Census Tract 208.01, San Diego County, California",1734,90,1580,101,154,64
6073020805,"Census Tract 208.05, San Diego County, California",997,95,568,97,429,123
6073020806,"Census Tract 208.06, San Diego County, California",1857,103,956,137,901,152
6073020807,"Census Tract 208.07, San Diego County, California",890,100,741,93,149,85
6073020808,"Census Tract 208.08, San Diego County, California",3680,131,3436,159,244,148
6073020809,"Census Tract 208.09, San Diego County, California",2039,102,1287,174,752,178
6073020902,"Census Tract 209.02, San Diego County, California",823,109,588,142,235,151
6073020903,"Census Tract 209.03, San Diego County, California",1157,115,941,97,216,68
6073020904,"Census Tract 209.04, San Diego County, California",1184,121,915,126,269,98
6073021000,"Census Tract 210, San Diego County, California",1342,214,1074,207,268,118
6073021100,"Census Tract 211, San Diego County, California",2124,246,1644,238,480,153
6073021202,"Census Tract 212.02, San Diego County, California",1081,111,853,128,228,124
6073021203,"Census Tract 212.03, San Diego County, California",3237,178,2011,233,1226,197
6073021204,"Census Tract 212.04, San Diego County, California",1718,101,1467,140,251,110
6073021302,"Census Tract 213.02, San Diego County, California",1457,100,1271,127,186,73
6073021303,"Census Tract 213.03, San Diego County, California",2355,155,2070,188,285,124
6073021304,"Census Tract 213.04, San Diego County, California",804,55,709,62,95,55
6075010100,"Census Tract 101, San Francisco County, California",1916,134,262,95,1654,170
6075010200,"Census Tract 102, San Francisco County, California",2772,173,961,163,1811,218
6075010300,"Census Tract 103, San Francisco County, California",1881,167,566,120,1315,163
6075010400,"Census Tract 104, San Francisco County, California",2489,202,748,160,1741,225
6075010500,"Census Tract 105, San Francisco County, California",1487,137,400,68,1087,149
6075010600,"Census Tract 106, San Francisco County, California",1787,177,220,87,1567,185
6075010700,"Census Tract 107, San Francisco County, California",2633,123,121,71,2512,141
6075010800,"Census Tract 108, San Francisco County, California",2391,162,665,164,1726,206
6075010900,"Census Tract 109, San Francisco County, California",2574,173,592,140,1982,222
6075011000,"Census Tract 110, San Francisco County, California",2461,137,209,87,2252,162
6075011100,"Census Tract 111, San Francisco County, California",2675,170,250,116,2425,202
6075011200,"Census Tract 112, San Francisco County, California",1770,195,465,106,1305,189
6075011300,"Census Tract 113, San Francisco County, California",1478,86,187,64,1291,96
6075011400,"Census Tract 114, San Francisco County, California",1479,90,40,39,1439,97
6075011500,"Census Tract 115, San Francisco County, California",511,71,8,14,503,74
6075011700,"Census Tract 117, San Francisco County, California",928,97,25,24,903,94
6075011800,"Census Tract 118, San Francisco County, California",615,75,28,26,587,76
6075011900,"Census Tract 119, San Francisco County, California",2896,183,467,146,2429,198
6075012000,"Census Tract 120, San Francisco County, California",2226,182,24,28,2202,181
6075012100,"Census Tract 121, San Francisco County, California",1832,148,63,39,1769,157
6075012200,"Census Tract 122, San Francisco County, California",3791,198,127,60,3664,197
6075012300,"Census Tract 123, San Francisco County, California",2994,212,23,26,2971,214
6075012400,"Census Tract 124, San Francisco County, California",3973,233,36,28,3937,236
6075012500,"Census Tract 125, San Francisco County, California",3988,259,47,41,3941,258
6075012600,"Census Tract 126, San Francisco County, California",2925,234,558,130,2367,242
6075012700,"Census Tract 127, San Francisco County, California",2050,177,697,164,1353,222
6075012800,"Census Tract 128, San Francisco County, California",2241,224,808,182,1433,244
6075012900,"Census Tract 129, San Francisco County, California",3410,188,643,154,2767,197
6075013000,"Census Tract 130, San Francisco County, California",2387,149,555,152,1832,186
6075013100,"Census Tract 131, San Francisco County, California",4065,155,714,131,3351,190
6075013200,"Census Tract 132, San Francisco County, California",2495,132,1059,164,1436,175
6075013300,"Census Tract 133, San Francisco County, California",1640,156,976,137,664,146
6075013400,"Census Tract 134, San Francisco County, California",1840,245,639,137,1201,271
6075013500,"Census Tract 135, San Francisco County, California",1774,91,475,99,1299,117
6075015100,"Census Tract 151, San Francisco County, California",1469,104,457,119,1012,133
6075015200,"Census Tract 152, San Francisco County, California",2482,146,643,149,1839,195
6075015300,"Census Tract 153, San Francisco County, California",951,88,356,74,595,104
6075015400,"Census Tract 154, San Francisco County, California",2938,99,954,164,1984,177
6075015500,"Census Tract 155, San Francisco County, California",2116,154,266,102,1850,160
6075015600,"Census Tract 156, San Francisco County, California",1208,79,440,97,768,105
6075015700,"Census Tract 157, San Francisco County, California",2276,183,729,144,1547,179
6075015800,"Census Tract 158, San Francisco County, California",3037,188,781,175,2256,214
6075015900,"Census Tract 159, San Francisco County, California",2030,136,496,120,1534,163
6075016000,"Census Tract 160, San Francisco County, California",1421,76,505,106,916,110
6075016100,"Census Tract 161, San Francisco County, California",2714,181,262,106,2452,191
6075016200,"Census Tract 162, San Francisco County, California",1347,112,120,74,1227,122
6075016300,"Census Tract 163, San Francisco County, California",1817,167,418,113,1399,175
6075016400,"Census Tract 164, San Francisco County, California",1845,131,301,94,1544,131
6075016500,"Census Tract 165, San Francisco County, California",2253,177,644,137,1609,194
6075016600,"Census Tract 166, San Francisco County, California",2438,156,536,142,1902,214
6075016700,"Census Tract 167, San Francisco County, California",2254,159,563,127,1691,207
6075016800,"Census Tract 168, San Francisco County, California",3097,244,588,159,2509,291
6075016900,"Census Tract 169, San Francisco County, California",1778,72,420,103,1358,121
6075017000,"Census Tract 170, San Francisco County, California",2105,164,946,161,1159,166
6075017100,"Census Tract 171, San Francisco County, California",3428,168,1328,170,2100,190
6075017601,"Census Tract 176.01, San Francisco County, California",2716,224,155,74,2561,226
6075017602,"Census Tract 176.02, San Francisco County, California",694,121,194,76,500,100
6075017700,"Census Tract 177, San Francisco County, California",689,70,136,69,553,92
6075017800,"Census Tract 178, San Francisco County, California",3480,197,892,175,2588,234
6075017901,"Census Tract 179.01, San Francisco County, California",4074,235,1821,206,2253,214
6075017902,"Census Tract 179.02, San Francisco County, California",643,71,11,18,632,70
6075018000,"Census Tract 180, San Francisco County, California",1023,53,439,86,584,83
6075020100,"Census Tract 201, San Francisco County, California",2443,163,530,143,1913,208
6075020200,"Census Tract 202, San Francisco County, California",2764,187,478,137,2286,212
6075020300,"Census Tract 203, San Francisco County, California",1625,118,585,150,1040,162
6075020400,"Census Tract 204, San Francisco County, California",4105,188,1206,151,2899,256
6075020500,"Census Tract 205, San Francisco County, California",1437,85,508,104,929,126
6075020600,"Census Tract 206, San Francisco County, California",2762,146,1097,180,1665,190
6075020700,"Census Tract 207, San Francisco County, California",3002,102,863,220,2139,230
6075020800,"Census Tract 208, San Francisco County, California",2485,119,477,143,2008,169
6075020900,"Census Tract 209, San Francisco County, California",1844,84,153,78,1691,130
6075021000,"Census Tract 210, San Francisco County, California",2030,122,582,135,1448,167
6075021100,"Census Tract 211, San Francisco County, California",2181,52,1040,206,1141,209
6075021200,"Census Tract 212, San Francisco County, California",1374,123,853,129,521,139
6075021300,"Census Tract 213, San Francisco County, California",1343,44,752,111,591,115
6075021400,"Census Tract 214, San Francisco County, California",1800,82,646,125,1154,118
6075021500,"Census Tract 215, San Francisco County, California",2365,176,973,151,1392,205
6075021600,"Census Tract 216, San Francisco County, California",2304,127,1453,163,851,159
6075021700,"Census Tract 217, San Francisco County, California",1898,123,1276,142,622,122
6075021800,"Census Tract 218, San Francisco County, California",1909,87,1310,137,599,128
6075022600,"Census Tract 226, San Francisco County, California",772,51,479,100,293,99
6075022701,"Census Tract 227.01, San Francisco County, California",1490,95,714,132,776,136
6075022702,"Census Tract 227.02, San Francisco County, California",1074,78,478,109,596,113
6075022703,"Census Tract 227.03, San Francisco County, California",2477,146,950,159,1527,199
6075022801,"Census Tract 228.01, San Francisco County, California",1507,105,498,98,1009,132
6075022802,"Census Tract 228.02, San Francisco County, California",627,49,154,72,473,83
6075022803,"Census Tract 228.03, San Francisco County, California",1491,85,484,94,1007,118
6075022901,"Census Tract 229.01, San Francisco County, California",1363,85,536,111,827,109
6075022902,"Census Tract 229.02, San Francisco County, California",828,52,353,109,475,100
6075022903,"Census Tract 229.03, San Francisco County, California",1118,80,500,108,618,109
6075023001,"Census Tract 230.01, San Francisco County, California",1269,95,832,112,437,140
6075023002,"Census Tract 230.02, San Francisco County, California",676,77,260,81,416,88
6075023003,"Census Tract 230.03, San Francisco County, California",1036,106,728,102,308,91
6075023101,"Census Tract 231.01, San Francisco County, California",361,51,276,58,85,39
6075023102,"Census Tract 231.02, San Francisco County, California",1084,107,384,83,700,138
6075023103,"Census Tract 231.03, San Francisco County, California",1225,104,227,97,998,134
6075023200,"Census Tract 232, San Francisco County, California",1236,94,702,125,534,145
6075023300,"Census Tract 233, San Francisco County, California",516,47,325,81,191,75
6075023400,"Census Tract 234, San Francisco County, California",910,71,433,93,477,86
6075025100,"Census Tract 251, San Francisco County, California",1343,78,859,88,484,97
6075025200,"Census Tract 252, San Francisco County, California",2202,132,1471,172,731,166
6075025300,"Census Tract 253, San Francisco County, California",1800,95,853,117,947,112
6075025401,"Census Tract 254.01, San Francisco County, California",1340,78,549,122,791,122
6075025402,"Census Tract 254.02, San Francisco County, California",1105,74,885,108,220,93
6075025403,"Census Tract 254.03, San Francisco County, California",1378,90,670,117,708,112
6075025500,"Census Tract 255, San Francisco County, California",2286,99,1523,166,763,152
6075025600,"Census Tract 256, San Francisco County, California",1431,75,1161,103,270,93
6075025700,"Census Tract 257, San Francisco County, California",2297,136,1450,163,847,175
6075025800,"Census Tract 258, San Francisco County, California",579,58,385,65,194,77
6075025900,"Census Tract 259, San Francisco County, California",1253,96,978,104,275,95
6075026001,"Census Tract 260.01, San Francisco County, California",1350,91,788,116,562,122
6075026002,"Census Tract 260.02, San Francisco County, California",927,75,755,118,172,106
6075026003,"Census Tract 260.03, San Francisco County, California",1201,82,933,112,268,106
6075026004,"Census Tract 260.04, San Francisco County, California",1054,63,840,93,214,72
6075026100,"Census Tract 261, San Francisco County, California",1564,74,983,104,581,104
6075026200,"Census Tract 262, San Francisco County, California",1581,108,945,126,636,134
6075026301,"Census Tract 263.01, San Francisco County, California",954,112,569,110,385,107
6075026302,"Census Tract 263.02, San Francisco County, California",1302,60,938,112,364,107
6075026303,"Census Tract 263.03, San Francisco County, California",1131,88,788,112,343,94
6075026401,"Census Tract 264.01, San Francisco County, California",955,45,588,97,367,90
6075026402,"Census Tract 264.02, San Francisco County, California",982,71,786,95,196,93
6075026403,"Census Tract 264.03, San Francisco County, California",964,84,512,97,452,120
6075026404,"Census Tract 264.04, San Francisco County, California",664,44,425,111,239,94
6075030101,"Census Tract 301.01, San Francisco County, California",1924,147,462,94,1462,152
6075030102,"Census Tract 301.02, San Francisco County, California",2269,157,1126,128,1143,177
6075030201,"Census Tract 302.01, San Francisco County, California",1864,79,468,96,1396,114
6075030202,"Census Tract 302.02, San Francisco County, California",1956,137,464,137,1492,171
6075030301,"Census Tract 303.01, San Francisco County, California",2351,132,1157,153,1194,174
6075030302,"Census Tract 303.02, San Francisco County, California",1226,86,993,113,233,88
6075030400,"Census Tract 304, San Francisco County, California",1868,92,1591,110,277,93
6075030500,"Census Tract 305, San Francisco County, California",1003,63,793,101,210,84
6075030600,"Census Tract 306, San Francisco County, California",800,72,703,85,97,70
6075030700,"Census Tract 307, San Francisco County, California",2644,100,2414,136,230,108
6075030800,"Census Tract 308, San Francisco County, California",2082,106,1606,141,476,109
6075030900,"Census Tract 309, San Francisco County, California",2302,85,2000,126,302,117
6075031000,"Census Tract 310, San Francisco County, California",1230,90,1031,111,199,63
6075031100,"Census Tract 311, San Francisco County, California",2493,96,1756,210,737,184
6075031200,"Census Tract 312, San Francisco County, California",2198,155,1513,216,685,206
6075031300,"Census Tract 313, San Francisco County, California",2693,157,1960,212,733,193
6075031400,"Census Tract 314, San Francisco County, California",1698,94,1231,148,467,137
6075032600,"Census Tract 326, San Francisco County, California",3094,149,1283,157,1811,208
6075032700,"Census Tract 327, San Francisco County, California",2295,104,1340,157,955,163
6075032800,"Census Tract 328, San Francisco County, California",2637,167,1758,226,879,185
6075032900,"Census Tract 329, San Francisco County, California",2851,97,2014,213,837,211
6075033000,"Census Tract 330, San Francisco County, California",2590,118,1893,196,697,157
6075033100,"Census Tract 331, San Francisco County, California",1335,90,1177,112,158,74
6075033201,"Census Tract 332.01, San Francisco County, California",689,54,0,132,689,54
6075033202,"Census Tract 332.02, San Francisco County, California",2505,195,16,25,2489,196
6075035100,"Census Tract 351, San Francisco County, California",2517,108,1468,147,1049,185
6075035201,"Census Tract 352.01, San Francisco County, California",1763,124,1073,141,690,157
6075035202,"Census Tract 352.02, San Francisco County, California",1669,92,660,112,1009,117
6075035300,"Census Tract 353, San Francisco County, California",2099,127,1462,153,637,128
6075035400,"Census Tract 354, San Francisco County, California",2176,109,1252,220,924,208
6075040100,"Census Tract 401, San Francisco County, California",1961,121,479,102,1482,150
6075040200,"Census Tract 402, San Francisco County, California",2147,158,727,159,1420,186
6075042600,"Census Tract 426, San Francisco County, California",3036,170,868,156,2168,183
6075042700,"Census Tract 427, San Francisco County, California",2348,131,768,159,1580,180
6075042800,"Census Tract 428, San Francisco County, California",907,71,789,88,118,59
6075045100,"Census Tract 451, San Francisco County, California",1985,110,668,124,1317,146
6075045200,"Census Tract 452, San Francisco County, California",2639,151,893,153,1746,187
6075047600,"Census Tract 476, San Francisco County, California",2094,144,820,172,1274,191
6075047701,"Census Tract 477.01, San Francisco County, California",1797,137,621,126,1176,134
6075047702,"Census Tract 477.02, San Francisco County, California",1516,83,778,119,738,111
6075047800,"Census Tract 478, San Francisco County, California",2981,168,1352,231,1629,230
6075047901,"Census Tract 479.01, San Francisco County, California",2564,139,1231,209,1333,216
6075047902,"Census Tract 479.02, San Francisco County, California",1396,98,725,115,671,131
6075060100,"Census Tract 601, San Francisco County, California",884,139,15,25,869,140
6075060200,"Census Tract 602, San Francisco County, California",81,31,53,35,28,22
6075060300,"Census Tract 603, San Francisco County, California",42,24,10,17,32,22
6075060400,"Census Tract 604, San Francisco County, California",1504,109,182,61,1322,115
6075060501,"Census Tract 605.01, San Francisco County, California",181,75,81,63,100,45
6075060502,"Census Tract 605.02, San Francisco County, California",867,96,185,68,682,92
6075060600,"Census Tract 606, San Francisco County, California",111,47,75,30,36,39
6075060700,"Census Tract 607, San Francisco County, California",2193,132,627,134,1566,171
6075060900,"Census Tract 609, San Francisco County, California",204,72,56,45,148,75
6075061000,"Census Tract 610, San Francisco County, California",855,84,555,116,300,111
6077000100,"Census Tract 1, San Joaquin County, California",1643,147,42,36,1601,144
6077000300,"Census Tract 3, San Joaquin County, California",827,101,92,50,735,109
6077000401,"Census Tract 4.01, San Joaquin County, California",1287,88,693,89,594,96
6077000402,"Census Tract 4.02, San Joaquin County, California",1782,166,295,97,1487,183
6077000500,"Census Tract 5, San Joaquin County, California",830,97,413,155,417,159
6077000600,"Census Tract 6, San Joaquin County, California",488,70,205,93,283,95
6077000700,"Census Tract 7, San Joaquin County, California",1369,102,604,117,765,138
6077000800,"Census Tract 8, San Joaquin County, California",490,71,288,70,202,84
6077000900,"Census Tract 9, San Joaquin County, California",1983,129,1043,168,940,187
6077001000,"Census Tract 10, San Joaquin County, California",1897,128,1265,163,632,163
6077001101,"Census Tract 11.01, San Joaquin County, California",1718,114,1037,114,681,155
6077001102,"Census Tract 11.02, San Joaquin County, California",1844,144,922,156,922,164
6077001200,"Census Tract 12, San Joaquin County, California",1768,113,1293,114,475,135
6077001300,"Census Tract 13, San Joaquin County, California",1971,87,1248,152,723,154
6077001400,"Census Tract 14, San Joaquin County, California",1716,108,889,126,827,134
6077001500,"Census Tract 15, San Joaquin County, California",2260,142,1393,166,867,174
6077001600,"Census Tract 16, San Joaquin County, California",693,30,362,99,331,98
6077001700,"Census Tract 17, San Joaquin County, California",1104,87,618,107,486,108
6077001800,"Census Tract 18, San Joaquin County, California",1107,93,683,85,424,106
6077001900,"Census Tract 19, San Joaquin County, California",1353,82,753,120,600,119
6077002000,"Census Tract 20, San Joaquin County, California",1100,81,686,109,414,99
6077002100,"Census Tract 21, San Joaquin County, California",1270,104,758,120,512,133
6077002200,"Census Tract 22, San Joaquin County, California",1947,123,1035,168,912,178
6077002300,"Census Tract 23, San Joaquin County, California",1325,101,549,103,776,125
6077002400,"Census Tract 24, San Joaquin County, California",1864,115,1119,160,745,167
6077002501,"Census Tract 25.01, San Joaquin County, California",1120,97,842,118,278,103
6077002502,"Census Tract 25.02, San Joaquin County, California",1716,99,948,153,768,151
6077002701,"Census Tract 27.01, San Joaquin County, California",1701,130,1248,139,453,109
6077002702,"Census Tract 27.02, San Joaquin County, California",1027,97,682,105,345,107
6077002800,"Census Tract 28, San Joaquin County, California",1415,119,1036,159,379,146
6077003106,"Census Tract 31.06, San Joaquin County, California",1708,93,1205,129,503,111
6077003108,"Census Tract 31.08, San Joaquin County, California",1877,130,668,133,1209,174
6077003109,"Census Tract 31.09, San Joaquin County, California",2051,128,1321,176,730,159
6077003110,"Census Tract 31.10, San Joaquin County, California",1658,87,462,113,1196,135
6077003111,"Census Tract 31.11, San Joaquin County, California",1798,80,410,70,1388,107
6077003112,"Census Tract 31.12, San Joaquin County, California",1347,85,779,97,568,98
6077003113,"Census Tract 31.13, San Joaquin County, California",2143,151,338,93,1805,175
6077003114,"Census Tract 31.14, San Joaquin County, California",3591,169,2940,167,651,128
6077003203,"Census Tract 32.03, San Joaquin County, California",1352,87,1110,91,242,76
6077003205,"Census Tract 32.05, San Joaquin County, California",1271,76,909,100,362,84
6077003208,"Census Tract 32.08, San Joaquin County, California",3443,178,2656,223,787,196
6077003209,"Census Tract 32.09, San Joaquin County, California",1335,47,1053,106,282,103
6077003210,"Census Tract 32.10, San Joaquin County, California",1055,55,610,116,445,114
6077003211,"Census Tract 32.11, San Joaquin County, California",1944,88,930,135,1014,159
6077003213,"Census Tract 32.13, San Joaquin County, California",1320,69,748,109,572,106
6077003214,"Census Tract 32.14, San Joaquin County, California",954,65,881,74,73,43
6077003215,"Census Tract 32.15, San Joaquin County, California",1572,115,538,106,1034,102
6077003305,"Census Tract 33.05, San Joaquin County, California",1449,102,939,154,510,138
6077003306,"Census Tract 33.06, San Joaquin County, California",1406,69,646,109,760,121
6077003307,"Census Tract 33.07, San Joaquin County, California",1674,118,695,123,979,151
6077003308,"Census Tract 33.08, San Joaquin County, California",637,67,253,81,384,104
6077003309,"Census Tract 33.09, San Joaquin County, California",1960,114,326,125,1634,150
6077003310,"Census Tract 33.10, San Joaquin County, California",1513,71,642,100,871,116
6077003311,"Census Tract 33.11, San Joaquin County, California",1134,62,543,93,591,88
6077003403,"Census Tract 34.03, San Joaquin County, California",1114,86,652,106,462,158
6077003404,"Census Tract 34.04, San Joaquin County, California",1646,115,1076,147,570,130
6077003405,"Census Tract 34.05, San Joaquin County, California",1099,47,561,106,538,102
6077003406,"Census Tract 34.06, San Joaquin County, California",1176,77,461,96,715,91
6077003407,"Census Tract 34.07, San Joaquin County, California",960,69,198,73,762,94
6077003408,"Census Tract 34.08, San Joaquin County, California",3045,141,1766,228,1279,230
6077003500,"Census Tract 35, San Joaquin County, California",5047,240,4243,248,804,171
6077003601,"Census Tract 36.01, San Joaquin County, California",1169,121,1009,111,160,87
6077003602,"Census Tract 36.02, San Joaquin County, California",991,90,685,100,306,103
6077003700,"Census Tract 37, San Joaquin County, California",1072,92,759,115,313,111
6077003801,"Census Tract 38.01, San Joaquin County, California",2845,181,2424,178,421,162
6077003802,"Census Tract 38.02, San Joaquin County, California",1612,116,1377,151,235,114
6077003803,"Census Tract 38.03, San Joaquin County, California",1049,131,634,138,415,119
6077003900,"Census Tract 39, San Joaquin County, California",402,74,186,54,216,71
6077004001,"Census Tract 40.01, San Joaquin County, California",873,101,518,76,355,84
6077004002,"Census Tract 40.02, San Joaquin County, California",2884,163,2101,230,783,187
6077004102,"Census Tract 41.02, San Joaquin County, California",2106,146,1551,161,555,178
6077004103,"Census Tract 41.03, San Joaquin County, California",2509,133,1785,194,724,192
6077004104,"Census Tract 41.04, San Joaquin County, California",1190,86,1124,92,66,57
6077004201,"Census Tract 42.01, San Joaquin County, California",2465,164,1504,158,961,173
6077004202,"Census Tract 42.02, San Joaquin County, California",613,58,566,64,47,32
6077004203,"Census Tract 42.03, San Joaquin County, California",1326,128,578,128,748,125
6077004204,"Census Tract 42.04, San Joaquin County, California",1248,90,505,93,743,114
6077004302,"Census Tract 43.02, San Joaquin County, California",2127,141,1034,180,1093,163
6077004303,"Census Tract 43.03, San Joaquin County, California",1784,147,1361,153,423,113
6077004305,"Census Tract 43.05, San Joaquin County, California",1804,140,940,135,864,138
6077004306,"Census Tract 43.06, San Joaquin County, California",2548,181,1133,166,1415,197
6077004401,"Census Tract 44.01, San Joaquin County, California",1848,161,748,167,1100,190
6077004402,"Census Tract 44.02, San Joaquin County, California",1603,115,1065,150,538,142
6077004500,"Census Tract 45, San Joaquin County, California",1916,143,721,109,1195,143
6077004600,"Census Tract 46, San Joaquin County, California",1874,161,1343,168,531,153
6077004701,"Census Tract 47.01, San Joaquin County, California",1052,66,810,112,242,105
6077004702,"Census Tract 47.02, San Joaquin County, California",2654,175,2134,188,520,161
6077004800,"Census Tract 48, San Joaquin County, California",1693,113,1230,128,463,106
6077004901,"Census Tract 49.01, San Joaquin County, California",2747,180,2109,180,638,212
6077004902,"Census Tract 49.02, San Joaquin County, California",1854,159,1259,127,595,166
6077005001,"Census Tract 50.01, San Joaquin County, California",1964,126,1211,132,753,142
6077005003,"Census Tract 50.03, San Joaquin County, California",1588,116,1410,123,178,90
6077005004,"Census Tract 50.04, San Joaquin County, California",1836,104,1435,133,401,102
6077005106,"Census Tract 51.06, San Joaquin County, California",1759,93,1253,150,506,165
6077005108,"Census Tract 51.08, San Joaquin County, California",1365,121,596,133,769,142
6077005109,"Census Tract 51.09, San Joaquin County, California",1460,74,547,125,913,122
6077005110,"Census Tract 51.10, San Joaquin County, California",2227,84,1603,160,624,141
6077005111,"Census Tract 51.11, San Joaquin County, California",170,48,128,54,42,42
6077005112,"Census Tract 51.12, San Joaquin County, California",990,80,783,110,207,103
6077005113,"Census Tract 51.13, San Joaquin County, California",2084,125,1510,115,574,109
6077005114,"Census Tract 51.14, San Joaquin County, California",1731,110,1390,123,341,117
6077005115,"Census Tract 51.15, San Joaquin County, California",2268,162,1397,181,871,213
6077005118,"Census Tract 51.18, San Joaquin County, California",3056,119,2573,172,483,149
6077005119,"Census Tract 51.19, San Joaquin County, California",1125,122,825,162,300,110
6077005122,"Census Tract 51.22, San Joaquin County, California",1457,136,885,183,572,212
6077005123,"Census Tract 51.23, San Joaquin County, California",1536,103,898,108,638,122
6077005124,"Census Tract 51.24, San Joaquin County, California",1230,89,651,101,579,110
6077005125,"Census Tract 51.25, San Joaquin County, California",577,75,440,74,137,74
6077005126,"Census Tract 51.26, San Joaquin County, California",1243,103,666,102,577,121
6077005127,"Census Tract 51.27, San Joaquin County, California",1443,136,1343,133,100,63
6077005128,"Census Tract 51.28, San Joaquin County, California",2064,130,1622,175,442,134
6077005202,"Census Tract 52.02, San Joaquin County, California",1855,101,1467,125,388,105
6077005203,"Census Tract 52.03, San Joaquin County, California",6881,320,5547,310,1334,228
6077005205,"Census Tract 52.05, San Joaquin County, California",6495,216,5342,290,1153,241
6077005302,"Census Tract 53.02, San Joaquin County, California",1954,120,1445,163,509,138
6077005303,"Census Tract 53.03, San Joaquin County, California",1504,90,430,96,1074,117
6077005305,"Census Tract 53.05, San Joaquin County, California",1797,132,992,119,805,115
6077005306,"Census Tract 53.06, San Joaquin County, California",2270,125,1342,183,928,183
6077005403,"Census Tract 54.03, San Joaquin County, California",1839,80,1413,127,426,104
6077005404,"Census Tract 54.04, San Joaquin County, California",1857,152,926,154,931,163
6077005500,"Census Tract 55, San Joaquin County, California",1290,102,1019,112,271,74
6079010000,"Census Tract 100, San Luis Obispo County, California",3222,236,2488,212,734,190
6079010100,"Census Tract 101, San Luis Obispo County, California",3372,213,1326,209,2046,248
6079010201,"Census Tract 102.01, San Luis Obispo County, California",2521,132,2131,153,390,117
6079010202,"Census Tract 102.02, San Luis Obispo County, California",1893,104,1452,150,441,114
6079010203,"Census Tract 102.03, San Luis Obispo County, California",3371,198,2305,174,1066,187
6079010300,"Census Tract 103, San Luis Obispo County, California",3454,192,2579,228,875,239
6079010400,"Census Tract 104, San Luis Obispo County, California",2944,246,2279,250,665,189
6079010500,"Census Tract 105, San Luis Obispo County, California",3968,480,2396,340,1572,328
6079010600,"Census Tract 106, San Luis Obispo County, California",2346,477,1317,323,1029,252
6079010701,"Census Tract 107.01, San Luis Obispo County, California",1903,89,1360,127,543,115
6079010702,"Census Tract 107.02, San Luis Obispo County, California",2879,128,2137,204,742,182
6079010703,"Census Tract 107.03, San Luis Obispo County, California",1431,119,839,183,592,132
6079010800,"Census Tract 108, San Luis Obispo County, California",851,143,502,102,349,128
6079010901,"Census Tract 109.01, San Luis Obispo County, California",1375,179,38,34,1337,178
6079010902,"Census Tract 109.02, San Luis Obispo County, California",1975,202,210,71,1765,224
6079011000,"Census Tract 110, San Luis Obispo County, California",3235,185,1451,141,1784,225
6079011101,"Census Tract 111.01, San Luis Obispo County, California",2003,165,249,64,1754,160
6079011102,"Census Tract 111.02, San Luis Obispo County, California",2460,154,600,107,1860,181
6079011103,"Census Tract 111.03, San Luis Obispo County, California",1158,154,605,145,553,144
6079011200,"Census Tract 112, San Luis Obispo County, California",2872,235,1084,169,1788,289
6079011300,"Census Tract 113, San Luis Obispo County, California",2900,196,1302,127,1598,225
6079011400,"Census Tract 114, San Luis Obispo County, California",0,132,0,132,0,132
6079011501,"Census Tract 115.01, San Luis Obispo County, California",776,69,542,88,234,109
6079011502,"Census Tract 115.02, San Luis Obispo County, California",1317,103,1069,110,248,92
6079011600,"Census Tract 116, San Luis Obispo County, California",1562,137,1336,146,226,101
6079011700,"Census Tract 117, San Luis Obispo County, California",4187,244,2544,272,1643,242
6079011800,"Census Tract 118, San Luis Obispo County, California",2797,128,2447,129,350,132
6079011901,"Census Tract 119.01, San Luis Obispo County, California",1340,107,1004,99,336,126
6079011902,"Census Tract 119.02, San Luis Obispo County, California",3327,168,1761,206,1566,231
6079012000,"Census Tract 120, San Luis Obispo County, California",3068,201,1509,192,1559,252
6079012100,"Census Tract 121, San Luis Obispo County, California",2522,176,1055,221,1467,236
6079012200,"Census Tract 122, San Luis Obispo County, California",2580,162,1353,168,1227,222
6079012301,"Census Tract 123.01, San Luis Obispo County, California",3296,199,2561,247,735,206
6079012302,"Census Tract 123.02, San Luis Obispo County, California",1891,106,1440,125,451,116
6079012401,"Census Tract 124.01, San Luis Obispo County, California",1969,121,1420,154,549,138
6079012402,"Census Tract 124.02, San Luis Obispo County, California",3135,222,2608,200,527,213
6079012501,"Census Tract 125.01, San Luis Obispo County, California",1942,136,1475,139,467,112
6079012502,"Census Tract 125.02, San Luis Obispo County, California",2110,185,1027,186,1083,212
6079012503,"Census Tract 125.03, San Luis Obispo County, California",2171,216,997,129,1174,225
6079012600,"Census Tract 126, San Luis Obispo County, California",2830,209,2008,188,822,222
6079012702,"Census Tract 127.02, San Luis Obispo County, California",2365,134,1787,190,578,197
6079012703,"Census Tract 127.03, San Luis Obispo County, California",1825,129,1163,167,662,196
6079012704,"Census Tract 127.04, San Luis Obispo County, California",3445,166,2973,211,472,131
6079012800,"Census Tract 128, San Luis Obispo County, California",75,26,65,22,10,15
6081600100,"Census Tract 6001, San Mateo County, California",1555,143,955,162,600,110
6081600200,"Census Tract 6002, San Mateo County, California",999,93,735,109,264,92
6081600300,"Census Tract 6003, San Mateo County, California",1251,73,1069,109,182,99
6081600400,"Census Tract 6004, San Mateo County, California",2431,68,1718,175,713,172
6081600500,"Census Tract 6005, San Mateo County, California",2154,74,1287,183,867,168
6081600600,"Census Tract 6006, San Mateo County, California",1421,88,729,119,692,114
6081600700,"Census Tract 6007, San Mateo County, California",1962,119,1276,190,686,180
6081600800,"Census Tract 6008, San Mateo County, California",2687,210,241,77,2446,216
6081600900,"Census Tract 6009, San Mateo County, California",1505,85,1117,134,388,130
6081601000,"Census Tract 6010, San Mateo County, California",2050,160,1588,201,462,162
6081601100,"Census Tract 6011, San Mateo County, California",1938,107,1588,119,350,111
6081601200,"Census Tract 6012, San Mateo County, California",2024,170,1383,162,641,191
6081601300,"Census Tract 6013, San Mateo County, California",2244,163,515,119,1729,178
6081601400,"Census Tract 6014, San Mateo County, California",1840,113,1208,163,632,141
6081601501,"Census Tract 6015.01, San Mateo County, California",1296,80,946,197,350,178
6081601502,"Census Tract 6015.02, San Mateo County, California",1661,85,191,67,1470,116
6081601601,"Census Tract 6016.01, San Mateo County, California",984,47,679,67,305,65
6081601603,"Census Tract 6016.03, San Mateo County, California",1834,117,1175,138,659,156
6081601604,"Census Tract 6016.04, San Mateo County, California",1135,94,825,114,310,94
6081601605,"Census Tract 6016.05, San Mateo County, California",1723,65,1490,113,233,98
6081601700,"Census Tract 6017, San Mateo County, California",1391,41,1156,91,235,79
6081601800,"Census Tract 6018, San Mateo County, California",2085,104,1622,167,463,122
6081601900,"Census Tract 6019, San Mateo County, California",3381,137,1926,223,1455,246
6081602000,"Census Tract 6020, San Mateo County, California",2789,99,2103,206,686,176
6081602100,"Census Tract 6021, San Mateo County, California",932,64,327,91,605,104
6081602200,"Census Tract 6022, San Mateo County, California",2437,113,532,151,1905,192
6081602300,"Census Tract 6023, San Mateo County, California",1159,80,783,106,376,106
6081602400,"Census Tract 6024, San Mateo County, California",2685,107,1502,174,1183,183
6081602500,"Census Tract 6025, San Mateo County, California",1416,76,1276,102,140,65
6081602600,"Census Tract 6026, San Mateo County, California",2302,164,1671,184,631,151
6081602700,"Census Tract 6027, San Mateo County, California",1851,76,1017,115,834,107
6081602800,"Census Tract 6028, San Mateo County, California",1433,68,1145,83,288,63
6081602900,"Census Tract 6029, San Mateo County, California",1621,72,868,96,753,90
6081603000,"Census Tract 6030, San Mateo County, California",1799,98,814,108,985,142
6081603100,"Census Tract 6031, San Mateo County, California",1154,70,933,82,221,88
6081603200,"Census Tract 6032, San Mateo County, California",1408,49,1127,100,281,94
6081603300,"Census Tract 6033, San Mateo County, California",2222,109,1937,126,285,110
6081603400,"Census Tract 6034, San Mateo County, California",2050,81,1679,117,371,96
6081603500,"Census Tract 6035, San Mateo County, California",0,132,0,132,0,132
6081603600,"Census Tract 6036, San Mateo County, California",1544,104,1161,108,383,106
6081603700,"Census Tract 6037, San Mateo County, California",1662,62,1253,134,409,121
6081603800,"Census Tract 6038, San Mateo County, California",3878,157,2827,179,1051,172
6081603900,"Census Tract 6039, San Mateo County, California",1906,133,1093,125,813,166
6081604000,"Census Tract 6040, San Mateo County, California",1106,43,979,71,127,57
6081604101,"Census Tract 6041.01, San Mateo County, California",2455,104,806,167,1649,178
6081604102,"Census Tract 6041.02, San Mateo County, California",1126,89,522,127,604,115
6081604200,"Census Tract 6042, San Mateo County, California",1007,80,497,113,510,118
6081604300,"Census Tract 6043, San Mateo County, California",0,132,0,132,0,132
6081604400,"Census Tract 6044, San Mateo County, California",1371,88,503,84,868,105
6081604500,"Census Tract 6045, San Mateo County, California",1262,74,950,91,312,98
6081604600,"Census Tract 6046, San Mateo County, California",901,54,829,65,72,44
6081604700,"Census Tract 6047, San Mateo County, California",993,43,829,84,164,73
6081604800,"Census Tract 6048, San Mateo County, California",1816,112,681,96,1135,137
6081604900,"Census Tract 6049, San Mateo County, California",1263,74,1054,94,209,78
6081605000,"Census Tract 6050, San Mateo County, California",2581,185,1776,186,805,149
6081605100,"Census Tract 6051, San Mateo County, California",1251,103,438,101,813,108
6081605200,"Census Tract 6052, San Mateo County, California",1141,94,940,94,201,71
6081605300,"Census Tract 6053, San Mateo County, California",1679,123,898,139,781,131
6081605400,"Census Tract 6054, San Mateo County, California",2383,175,1023,142,1360,188
6081605500,"Census Tract 6055, San Mateo County, California",2199,204,680,168,1519,226
6081605600,"Census Tract 6056, San Mateo County, California",1881,97,1816,104,65,44
6081605700,"Census Tract 6057, San Mateo County, California",1795,81,1742,91,53,57
6081605800,"Census Tract 6058, San Mateo County, California",1021,69,633,149,388,153
6081605900,"Census Tract 6059, San Mateo County, California",2569,128,1024,159,1545,195
6081606000,"Census Tract 6060, San Mateo County, California",2058,142,940,170,1118,181
6081606100,"Census Tract 6061, San Mateo County, California",1248,88,771,95,477,104
6081606200,"Census Tract 6062, San Mateo County, California",2212,114,687,171,1525,192
6081606300,"Census Tract 6063, San Mateo County, California",1634,131,848,148,786,145
6081606400,"Census Tract 6064, San Mateo County, California",2619,105,989,143,1630,174
6081606500,"Census Tract 6065, San Mateo County, California",1299,36,1110,69,189,64
6081606600,"Census Tract 6066, San Mateo County, California",1328,59,807,94,521,98
6081606700,"Census Tract 6067, San Mateo County, California",941,39,786,66,155,62
6081606800,"Census Tract 6068, San Mateo County, California",1391,59,1134,84,257,68
6081606900,"Census Tract 6069, San Mateo County, California",1008,38,898,64,110,54
6081607000,"Census Tract 6070, San Mateo County, California",1365,84,887,109,478,122
6081607100,"Census Tract 6071, San Mateo County, California",1084,51,944,64,140,62
6081607200,"Census Tract 6072, San Mateo County, California",1596,77,286,87,1310,104
6081607300,"Census Tract 6073, San Mateo County, California",1221,77,1050,90,171,80
6081607400,"Census Tract 6074, San Mateo County, California",1763,107,845,116,918,137
6081607500,"Census Tract 6075, San Mateo County, California",1371,123,621,78,750,132
6081607600,"Census Tract 6076, San Mateo County, California",1222,59,677,102,545,99
6081607701,"Census Tract 6077.01, San Mateo County, California",1124,100,768,112,356,113
6081607702,"Census Tract 6077.02, San Mateo County, California",793,29,664,61,129,58
6081607800,"Census Tract 6078, San Mateo County, California",820,102,715,101,105,64
6081607900,"Census Tract 6079, San Mateo County, California",1576,113,843,123,733,133
6081608001,"Census Tract 6080.01, San Mateo County, California",1273,75,509,84,764,106
6081608002,"Census Tract 6080.02, San Mateo County, California",1377,57,1161,96,216,89
6081608004,"Census Tract 6080.04, San Mateo County, California",2794,131,1313,180,1481,185
6081608013,"Census Tract 6080.13, San Mateo County, California",1345,112,805,109,540,100
6081608023,"Census Tract 6080.23, San Mateo County, California",789,41,720,56,69,44
6081608100,"Census Tract 6081, San Mateo County, California",1162,47,918,74,244,67
6081608200,"Census Tract 6082, San Mateo County, California",1270,51,723,78,547,74
6081608300,"Census Tract 6083, San Mateo County, California",1286,71,652,88,634,102
6081608400,"Census Tract 6084, San Mateo County, California",2095,146,755,103,1340,151
6081608501,"Census Tract 6085.01, San Mateo County, California",1693,72,1069,112,624,111
6081608502,"Census Tract 6085.02, San Mateo County, California",1155,50,659,105,496,104
6081608600,"Census Tract 6086, San Mateo County, California",1709,114,772,121,937,151
6081608700,"Census Tract 6087, San Mateo County, California",2659,127,1817,170,842,192
6081608800,"Census Tract 6088, San Mateo County, California",1985,117,1812,124,173,86
6081608900,"Census Tract 6089, San Mateo County, California",2915,138,1062,118,1853,148
6081609000,"Census Tract 6090, San Mateo County, California",981,69,776,79,205,76
6081609100,"Census Tract 6091, San Mateo County, California",543,41,422,61,121,48
6081609200,"Census Tract 6092, San Mateo County, California",3292,132,1546,145,1746,170
6081609300,"Census Tract 6093, San Mateo County, California",1225,46,1029,68,196,64
6081609400,"Census Tract 6094, San Mateo County, California",1006,54,847,86,159,71
6081609500,"Census Tract 6095, San Mateo County, California",1653,79,1500,93,153,58
6081609601,"Census Tract 6096.01, San Mateo County, California",1195,47,828,96,367,85
6081609602,"Census Tract 6096.02, San Mateo County, California",637,26,463,44,174,46
6081609603,"Census Tract 6096.03, San Mateo County, California",2003,87,1839,124,164,97
6081609700,"Census Tract 6097, San Mateo County, California",1788,89,1709,91,79,50
6081609800,"Census Tract 6098, San Mateo County, California",1644,79,1400,101,244,89
6081609900,"Census Tract 6099, San Mateo County, California",1040,36,933,66,107,56
6081610000,"Census Tract 6100, San Mateo County, California",1837,122,926,105,911,116
6081610100,"Census Tract 6101, San Mateo County, California",857,54,396,70,461,79
6081610201,"Census Tract 6102.01, San Mateo County, California",1585,91,408,93,1177,131
6081610202,"Census Tract 6102.02, San Mateo County, California",653,61,24,23,629,56
6081610203,"Census Tract 6102.03, San Mateo County, California",871,53,74,46,797,62
6081610302,"Census Tract 6103.02, San Mateo County, California",970,123,768,126,202,84
6081610303,"Census Tract 6103.03, San Mateo County, California",2814,145,1821,142,993,173
6081610304,"Census Tract 6103.04, San Mateo County, California",1844,67,1441,127,403,129
6081610400,"Census Tract 6104, San Mateo County, California",1415,80,695,93,720,107
6081610500,"Census Tract 6105, San Mateo County, California",1408,89,774,138,634,137
6081610601,"Census Tract 6106.01, San Mateo County, California",1711,102,541,110,1170,129
6081610602,"Census Tract 6106.02, San Mateo County, California",1255,80,1007,117,248,102
6081610700,"Census Tract 6107, San Mateo County, California",1838,112,685,138,1153,165
6081610800,"Census Tract 6108, San Mateo County, California",1536,64,184,83,1352,93
6081610900,"Census Tract 6109, San Mateo County, California",2213,129,603,135,1610,163
6081611000,"Census Tract 6110, San Mateo County, California",2087,113,913,151,1174,177
6081611100,"Census Tract 6111, San Mateo County, California",2236,80,1925,114,311,87
6081611200,"Census Tract 6112, San Mateo County, California",1049,31,915,71,134,60
6081611300,"Census Tract 6113, San Mateo County, California",1992,135,1391,133,601,129
6081611400,"Census Tract 6114, San Mateo County, California",1350,156,1243,148,107,57
6081611500,"Census Tract 6115, San Mateo County, California",880,102,805,107,75,44
6081611600,"Census Tract 6116, San Mateo County, California",780,42,638,58,142,50
6081611700,"Census Tract 6117, San Mateo County, California",1138,102,658,94,480,112
6081611800,"Census Tract 6118, San Mateo County, California",1194,105,809,120,385,96
6081611900,"Census Tract 6119, San Mateo County, California",3142,252,1907,248,1235,264
6081612000,"Census Tract 6120, San Mateo County, California",1970,152,1034,183,936,202
6081612100,"Census Tract 6121, San Mateo County, California",3099,229,564,137,2535,261
6081612200,"Census Tract 6122, San Mateo County, California",1612,94,987,92,625,86
6081612400,"Census Tract 6124, San Mateo County, California",464,45,448,42,16,19
6081612500,"Census Tract 6125, San Mateo County, California",1958,139,961,193,997,169
6081612600,"Census Tract 6126, San Mateo County, California",2095,138,522,116,1573,172
6081612700,"Census Tract 6127, San Mateo County, California",750,59,715,65,35,31
6081612800,"Census Tract 6128, San Mateo County, California",1111,67,981,84,130,65
6081612900,"Census Tract 6129, San Mateo County, California",1948,107,1589,121,359,105
6081613000,"Census Tract 6130, San Mateo County, California",1531,82,1064,88,467,72
6081613200,"Census Tract 6132, San Mateo County, California",2512,199,2004,171,508,135
6081613300,"Census Tract 6133, San Mateo County, California",901,90,867,91,34,24
6081613400,"Census Tract 6134, San Mateo County, California",1257,94,1081,94,176,66
6081613501,"Census Tract 6135.01, San Mateo County, California",1369,118,987,146,382,103
6081613502,"Census Tract 6135.02, San Mateo County, California",2253,142,1694,155,559,168
6081613600,"Census Tract 6136, San Mateo County, California",2201,145,1867,170,334,138
6081613700,"Census Tract 6137, San Mateo County, California",3669,235,2485,246,1184,183
6081613800,"Census Tract 6138, San Mateo County, California",1719,175,1203,165,516,143
6083000101,"Census Tract 1.01, Santa Barbara County, California",2260,128,1625,158,635,167
6083000102,"Census Tract 1.02, Santa Barbara County, California",2329,160,894,192,1435,228
6083000103,"Census Tract 1.03, Santa Barbara County, California",1228,82,1090,90,138,68
6083000200,"Census Tract 2, Santa Barbara County, California",2117,109,1026,106,1091,133
6083000300,"Census Tract 3, Santa Barbara County, California",3257,215,661,142,2596,248
6083000400,"Census Tract 4, Santa Barbara County, California",2305,162,1053,168,1252,206
6083000501,"Census Tract 5.01, Santa Barbara County, California",1346,117,1073,112,273,109
6083000502,"Census Tract 5.02, Santa Barbara County, California",2297,157,1581,201,716,169
6083000600,"Census Tract 6, Santa Barbara County, California",2211,156,1328,152,883,174
6083000700,"Census Tract 7, Santa Barbara County, California",2232,165,1632,163,600,154
6083000801,"Census Tract 8.01, Santa Barbara County, California",1086,92,327,89,759,120
6083000802,"Census Tract 8.02, Santa Barbara County, California",2097,178,687,153,1410,203
6083000900,"Census Tract 9, Santa Barbara County, California",1336,96,141,64,1195,118
6083001000,"Census Tract 10, Santa Barbara County, California",2801,186,408,124,2393,224
6083001101,"Census Tract 11.01, Santa Barbara County, California",1565,96,659,127,906,156
6083001102,"Census Tract 11.02, Santa Barbara County, California",1286,85,302,89,984,109
6083001202,"Census Tract 12.02, Santa Barbara County, California",1541,164,754,110,787,159
6083001203,"Census Tract 12.03, Santa Barbara County, California",1326,101,713,110,613,143
6083001204,"Census Tract 12.04, Santa Barbara County, California",1482,147,190,72,1292,151
6083001301,"Census Tract 13.01, Santa Barbara County, California",1402,100,865,121,537,115
6083001302,"Census Tract 13.02, Santa Barbara County, California",2969,142,2178,183,791,192
6083001400,"Census Tract 14, Santa Barbara County, California",1525,135,841,128,684,127
6083001500,"Census Tract 15, Santa Barbara County, California",1390,103,1113,112,277,113
6083001601,"Census Tract 16.01, Santa Barbara County, California",1784,126,1419,159,365,141
6083001602,"Census Tract 16.02, Santa Barbara County, California",2305,187,760,157,1545,228
6083001701,"Census Tract 17.01, Santa Barbara County, California",1944,174,1218,182,726,176
6083001702,"Census Tract 17.02, Santa Barbara County, California",1147,67,701,159,446,162
6083001800,"Census Tract 18, Santa Barbara County, California",408,59,286,50,122,46
6083001901,"Census Tract 19.01, Santa Barbara County, California",2348,218,1694,227,654,138
6083001903,"Census Tract 19.03, Santa Barbara County, California",2252,243,1363,235,889,160
6083001905,"Census Tract 19.05, Santa Barbara County, California",1262,89,1084,115,178,62
6083001906,"Census Tract 19.06, Santa Barbara County, California",2141,221,1474,206,667,203
6083002005,"Census Tract 20.05, Santa Barbara County, California",1840,101,1494,137,346,122
6083002006,"Census Tract 20.06, Santa Barbara County, California",867,44,682,76,185,55
6083002007,"Census Tract 20.07, Santa Barbara County, California",3049,149,2475,183,574,139
6083002008,"Census Tract 20.08, Santa Barbara County, California",2057,119,1736,145,321,124
6083002009,"Census Tract 20.09, Santa Barbara County, California",1277,66,964,102,313,90
6083002010,"Census Tract 20.10, Santa Barbara County, California",1568,74,1350,108,218,78
6083002011,"Census Tract 20.11, Santa Barbara County, California",1878,109,1416,156,462,159
6083002012,"Census Tract 20.12, Santa Barbara County, California",1206,84,915,85,291,116
6083002013,"Census Tract 20.13, Santa Barbara County, California",982,69,870,71,112,66
6083002101,"Census Tract 21.01, Santa Barbara County, California",1144,118,419,83,725,120
6083002102,"Census Tract 21.02, Santa Barbara County, California",723,57,416,60,307,77
6083002103,"Census Tract 21.03, Santa Barbara County, California",1436,98,382,83,1054,107
6083002205,"Census Tract 22.05, Santa Barbara County, California",1247,104,430,104,817,142
6083002206,"Census Tract 22.06, Santa Barbara County, California",1425,85,448,106,977,117
6083002209,"Census Tract 22.09, Santa Barbara County, California",741,79,488,102,253,71
6083002210,"Census Tract 22.10, Santa Barbara County, California",1460,72,1120,151,340,124
6083002211,"Census Tract 22.11, Santa Barbara County, California",1788,102,1473,121,315,106
6083002303,"Census Tract 23.03, Santa Barbara County, California",1243,76,778,103,465,98
6083002304,"Census Tract 23.04, Santa Barbara County, California",1285,97,344,84,941,113
6083002305,"Census Tract 23.05, Santa Barbara County, California",1381,70,851,141,530,124
6083002306,"Census Tract 23.06, Santa Barbara County, California",2224,92,1860,121,364,122
6083002402,"Census Tract 24.02, Santa Barbara County, California",2558,118,955,122,1603,167
6083002403,"Census Tract 24.03, Santa Barbara County, California",1450,82,234,70,1216,92
6083002404,"Census Tract 24.04, Santa Barbara County, California",1666,96,258,91,1408,123
6083002500,"Census Tract 25, Santa Barbara County, California",2053,166,1108,188,945,186
6083002603,"Census Tract 26.03, Santa Barbara County, California",1201,159,35,40,1166,152
6083002604,"Census Tract 26.04, Santa Barbara County, California",54,38,0,132,54,38
6083002702,"Census Tract 27.02, Santa Barbara County, California",2183,130,359,103,1824,145
6083002703,"Census Tract 27.03, Santa Barbara County, California",1253,101,811,116,442,112
6083002705,"Census Tract 27.05, Santa Barbara County, California",1527,85,560,115,967,128
6083002706,"Census Tract 27.06, Santa Barbara County, California",1993,115,795,107,1198,144
6083002707,"Census Tract 27.07, Santa Barbara County, California",982,77,499,98,483,96
6083002708,"Census Tract 27.08, Santa Barbara County, California",1200,79,568,110,632,146
6083002802,"Census Tract 28.02, Santa Barbara County, California",2623,138,1620,230,1003,208
6083002805,"Census Tract 28.05, Santa Barbara County, California",334,46,131,40,203,52
6083002806,"Census Tract 28.06, Santa Barbara County, California",563,63,497,41,66,54
6083002807,"Census Tract 28.07, Santa Barbara County, California",856,68,781,82,75,50
6083002808,"Census Tract 28.08, Santa Barbara County, California",2440,129,1973,169,467,130
6083002809,"Census Tract 28.09, Santa Barbara County, California",1631,112,1330,140,301,105
6083002902,"Census Tract 29.02, Santa Barbara County, California",1551,132,105,27,1446,131
6083002903,"Census Tract 29.03, Santa Barbara County, California",867,100,157,47,710,111
6083002904,"Census Tract 29.04, Santa Barbara County, California",3258,156,1136,158,2122,203
6083002906,"Census Tract 29.06, Santa Barbara County, California",1474,77,1292,102,182,86
6083002907,"Census Tract 29.07, Santa Barbara County, California",1378,66,1263,74,115,59
6083002909,"Census Tract 29.09, Santa Barbara County, California",1740,100,1448,138,292,92
6083002910,"Census Tract 29.10, Santa Barbara County, California",875,59,550,88,325,93
6083002911,"Census Tract 29.11, Santa Barbara County, California",1990,159,36,33,1954,161
6083002912,"Census Tract 29.12, Santa Barbara County, California",1765,151,7,13,1758,153
6083002913,"Census Tract 29.13, Santa Barbara County, California",1409,73,924,86,485,97
6083002914,"Census Tract 29.14, Santa Barbara County, California",1338,83,906,97,432,94
6083003001,"Census Tract 30.01, Santa Barbara County, California",1962,204,608,165,1354,175
6083003002,"Census Tract 30.02, Santa Barbara County, California",1378,98,1153,102,225,84
6083003004,"Census Tract 30.04, Santa Barbara County, California",1560,92,1303,117,257,106
6083003005,"Census Tract 30.05, Santa Barbara County, California",1590,69,894,137,696,144
6085500100,"Census Tract 5001, Santa Clara County, California",1949,101,723,126,1226,147
6085500200,"Census Tract 5002, Santa Clara County, California",2034,111,443,162,1591,195
6085500300,"Census Tract 5003, Santa Clara County, California",1135,65,372,96,763,106
6085500400,"Census Tract 5004, Santa Clara County, California",1029,69,361,99,668,110
6085500500,"Census Tract 5005, Santa Clara County, California",1825,112,1289,128,536,127
6085500600,"Census Tract 5006, Santa Clara County, California",2027,116,836,89,1191,143
6085500800,"Census Tract 5008, Santa Clara County, California",1075,97,296,77,779,130
6085500901,"Census Tract 5009.01, Santa Clara County, California",1575,119,158,61,1417,131
6085500902,"Census Tract 5009.02, Santa Clara County, California",512,96,26,27,486,102
6085501000,"Census Tract 5010, Santa Clara County, California",1876,135,376,125,1500,145
6085501100,"Census Tract 5011, Santa Clara County, California",3073,162,1364,173,1709,215
6085501200,"Census Tract 5012, Santa Clara County, California",1346,88,500,99,846,126
6085501300,"Census Tract 5013, Santa Clara County, California",1151,73,547,77,604,89
6085501400,"Census Tract 5014, Santa Clara County, California",1778,133,659,122,1119,155
6085501501,"Census Tract 5015.01, Santa Clara County, California",1137,49,371,82,766,95
6085501502,"Census Tract 5015.02, Santa Clara County, California",950,94,562,116,388,109
6085501600,"Census Tract 5016, Santa Clara County, California",2174,175,412,115,1762,207
6085501700,"Census Tract 5017, Santa Clara County, California",1269,87,409,90,860,125
6085501800,"Census Tract 5018, Santa Clara County, California",1627,108,1051,97,576,111
6085501900,"Census Tract 5019, Santa Clara County, California",1818,87,590,120,1228,130
6085502001,"Census Tract 5020.01, Santa Clara County, California",2042,116,687,131,1355,159
6085502002,"Census Tract 5020.02, Santa Clara County, California",1568,97,390,88,1178,133
6085502101,"Census Tract 5021.01, Santa Clara County, California",2019,93,1238,148,781,150
6085502102,"Census Tract 5021.02, Santa Clara County, California",2577,132,752,143,1825,181
6085502201,"Census Tract 5022.01, Santa Clara County, California",2570,142,456,134,2114,164
6085502202,"Census Tract 5022.02, Santa Clara County, California",1397,88,757,109,640,104
6085502300,"Census Tract 5023, Santa Clara County, California",2663,119,1323,178,1340,186
6085502400,"Census Tract 5024, Santa Clara County, California",2910,121,2299,182,611,147
6085502500,"Census Tract 5025, Santa Clara County, California",2395,133,1909,170,486,145
6085502601,"Census Tract 5026.01, Santa Clara County, California",1187,73,914,72,273,68
6085502602,"Census Tract 5026.02, Santa Clara County, California",3176,166,1516,197,1660,200
6085502701,"Census Tract 5027.01, Santa Clara County, California",1969,111,1110,95,859,125
6085502702,"Census Tract 5027.02, Santa Clara County, California",3086,91,2050,200,1036,186
6085502800,"Census Tract 5028, Santa Clara County, California",1349,88,1152,94,197,79
6085502901,"Census Tract 5029.01, Santa Clara County, California",2182,77,1509,125,673,130
6085502902,"Census Tract 5029.02, Santa Clara County, California",2547,100,2188,171,359,153
6085502903,"Census Tract 5029.03, Santa Clara County, California",1955,78,1719,108,236,88
6085502906,"Census Tract 5029.06, Santa Clara County, California",1766,30,1050,149,716,151
6085502907,"Census Tract 5029.07, Santa Clara County, California",1290,86,1131,78,159,64
6085502908,"Census Tract 5029.08, Santa Clara County, California",2360,98,1782,129,578,145
6085502909,"Census Tract 5029.09, Santa Clara County, California",2104,71,1087,138,1017,155
6085502910,"Census Tract 5029.10, Santa Clara County, California",1436,86,790,100,646,116
6085503001,"Census Tract 5030.01, Santa Clara County, California",1605,73,1277,133,328,110
6085503002,"Census Tract 5030.02, Santa Clara County, California",1396,37,936,84,460,87
6085503003,"Census Tract 5030.03, Santa Clara County, California",1864,25,1670,97,194,93
6085503103,"Census Tract 5031.03, Santa Clara County, California",4085,162,1539,237,2546,241
6085503105,"Census Tract 5031.05, Santa Clara County, California",755,37,269,81,486,78
6085503106,"Census Tract 5031.06, Santa Clara County, California",2395,124,817,158,1578,189
6085503108,"Census Tract 5031.08, Santa Clara County, California",2738,133,975,118,1763,152
6085503110,"Census Tract 5031.10, Santa Clara County, California",1107,56,314,78,793,94
6085503111,"Census Tract 5031.11, Santa Clara County, California",1041,71,745,112,296,103
6085503112,"Census Tract 5031.12, Santa Clara County, California",1237,98,501,111,736,121
6085503113,"Census Tract 5031.13, Santa Clara County, California",1228,64,486,114,742,108
6085503115,"Census Tract 5031.15, Santa Clara County, California",2154,105,1908,111,246,99
6085503116,"Census Tract 5031.16, Santa Clara County, California",2025,103,1235,132,790,144
6085503204,"Census Tract 5032.04, Santa Clara County, California",2108,94,1223,173,885,173
6085503207,"Census Tract 5032.07, Santa Clara County, California",985,59,854,85,131,75
6085503208,"Census Tract 5032.08, Santa Clara County, California",784,55,631,77,153,71
6085503210,"Census Tract 5032.10, Santa Clara County, California",964,42,610,87,354,87
6085503211,"Census Tract 5032.11, Santa Clara County, California",1052,79,753,132,299,103
6085503212,"Census Tract 5032.12, Santa Clara County, California",960,35,670,102,290,101
6085503213,"Census Tract 5032.13, Santa Clara County, California",1227,45,895,121,332,113
6085503214,"Census Tract 5032.14, Santa Clara County, California",1487,114,1037,147,450,125
6085503217,"Census Tract 5032.17, Santa Clara County, California",1038,72,739,132,299,110
6085503218,"Census Tract 5032.18, Santa Clara County, California",1130,69,427,95,703,124
6085503304,"Census Tract 5033.04, Santa Clara County, California",1826,77,986,131,840,138
6085503305,"Census Tract 5033.05, Santa Clara County, California",1437,63,817,114,620,116
6085503306,"Census Tract 5033.06, Santa Clara County, California",843,55,604,91,239,86
6085503312,"Census Tract 5033.12, Santa Clara County, California",989,53,811,79,178,69
6085503313,"Census Tract 5033.13, Santa Clara County, California",1419,22,1337,62,82,54
6085503315,"Census Tract 5033.15, Santa Clara County, California",1889,81,1232,108,657,130
6085503317,"Census Tract 5033.17, Santa Clara County, California",1967,59,1448,142,519,137
6085503319,"Census Tract 5033.19, Santa Clara County, California",2908,126,2721,150,187,113
6085503320,"Census Tract 5033.20, Santa Clara County, California",4060,75,3614,133,446,121
6085503321,"Census Tract 5033.21, Santa Clara County, California",1050,46,985,93,65,65
6085503322,"Census Tract 5033.22, Santa Clara County, California",1059,21,850,88,209,86
6085503323,"Census Tract 5033.23, Santa Clara County, California",1221,28,980,122,241,108
6085503324,"Census Tract 5033.24, Santa Clara County, California",893,53,676,90,217,97
6085503325,"Census Tract 5033.25, Santa Clara County, California",1071,87,814,103,257,102
6085503326,"Census Tract 5033.26, Santa Clara County, California",1499,70,1400,94,99,59
6085503327,"Census Tract 5033.27, Santa Clara County, California",1280,100,1066,99,214,90
6085503328,"Census Tract 5033.28, Santa Clara County, California",3820,70,3546,140,274,124
6085503401,"Census Tract 5034.01, Santa Clara County, California",946,87,605,111,341,96
6085503402,"Census Tract 5034.02, Santa Clara County, California",1025,36,401,89,624,93
6085503504,"Census Tract 5035.04, Santa Clara County, California",1154,35,724,100,430,97
6085503506,"Census Tract 5035.06, Santa Clara County, California",1179,98,712,120,467,107
6085503507,"Census Tract 5035.07, Santa Clara County, California",321,38,273,37,48,27
6085503508,"Census Tract 5035.08, Santa Clara County, California",1206,100,1002,119,204,100
6085503509,"Census Tract 5035.09, Santa Clara County, California",905,39,766,94,139,85
6085503510,"Census Tract 5035.10, Santa Clara County, California",1399,54,773,140,626,156
6085503511,"Census Tract 5035.11, Santa Clara County, California",769,69,685,87,84,58
6085503601,"Census Tract 5036.01, Santa Clara County, California",920,64,239,80,681,108
6085503602,"Census Tract 5036.02, Santa Clara County, California",1081,77,532,134,549,140
6085503702,"Census Tract 5037.02, Santa Clara County, California",1862,106,720,106,1142,134
6085503703,"Census Tract 5037.03, Santa Clara County, California",812,94,399,95,413,114
6085503706,"Census Tract 5037.06, Santa Clara County, California",2292,128,667,192,1625,192
6085503707,"Census Tract 5037.07, Santa Clara County, California",1366,77,866,122,500,117
6085503708,"Census Tract 5037.08, Santa Clara County, California",702,51,456,90,246,89
6085503709,"Census Tract 5037.09, Santa Clara County, California",1316,73,241,85,1075,103
6085503802,"Census Tract 5038.02, Santa Clara County, California",2181,108,1456,152,725,161
6085503803,"Census Tract 5038.03, Santa Clara County, California",1377,53,1034,115,343,110
6085503804,"Census Tract 5038.04, Santa Clara County, California",1466,83,1024,132,442,139
6085503900,"Census Tract 5039, Santa Clara County, California",2128,131,1346,166,782,183
6085504001,"Census Tract 5040.01, Santa Clara County, California",1567,81,916,128,651,109
6085504002,"Census Tract 5040.02, Santa Clara County, California",1183,71,674,94,509,108
6085504101,"Census Tract 5041.01, Santa Clara County, California",891,71,649,99,242,85
6085504102,"Census Tract 5041.02, Santa Clara County, California",1245,78,867,109,378,99
6085504201,"Census Tract 5042.01, Santa Clara County, California",1643,81,1341,104,302,82
6085504202,"Census Tract 5042.02, Santa Clara County, California",1381,102,1309,119,72,59
6085504307,"Census Tract 5043.07, Santa Clara County, California",1700,33,1334,106,366,104
6085504308,"Census Tract 5043.08, Santa Clara County, California",1476,60,1184,111,292,102
6085504310,"Census Tract 5043.10, Santa Clara County, California",3625,166,1511,207,2114,239
6085504311,"Census Tract 5043.11, Santa Clara County, California",2415,46,1730,157,685,157
6085504314,"Census Tract 5043.14, Santa Clara County, California",1270,40,1051,82,219,77
6085504315,"Census Tract 5043.15, Santa Clara County, California",2051,36,1711,140,340,134
6085504316,"Census Tract 5043.16, Santa Clara County, California",1384,26,1168,109,216,108
6085504317,"Census Tract 5043.17, Santa Clara County, California",1255,61,1078,88,177,64
6085504318,"Census Tract 5043.18, Santa Clara County, California",1286,137,1086,139,200,77
6085504319,"Census Tract 5043.19, Santa Clara County, California",1901,58,1330,110,571,109
6085504320,"Census Tract 5043.20, Santa Clara County, California",841,25,698,61,143,52
6085504321,"Census Tract 5043.21, Santa Clara County, California",1566,42,1061,120,505,119
6085504410,"Census Tract 5044.10, Santa Clara County, California",1187,68,776,115,411,118
6085504411,"Census Tract 5044.11, Santa Clara County, California",1530,58,1156,123,374,114
6085504412,"Census Tract 5044.12, Santa Clara County, California",1230,92,722,119,508,127
6085504413,"Census Tract 5044.13, Santa Clara County, California",730,27,447,66,283,68
6085504414,"Census Tract 5044.14, Santa Clara County, California",1418,78,1186,116,232,84
6085504415,"Census Tract 5044.15, Santa Clara County, California",1619,49,1331,103,288,94
6085504416,"Census Tract 5044.16, Santa Clara County, California",1081,84,884,121,197,108
6085504417,"Census Tract 5044.17, Santa Clara County, California",691,69,518,74,173,93
6085504418,"Census Tract 5044.18, Santa Clara County, California",1217,85,579,131,638,121
6085504420,"Census Tract 5044.20, Santa Clara County, California",1311,87,973,116,338,111
6085504421,"Census Tract 5044.21, Santa Clara County, California",1325,75,1048,117,277,104
6085504422,"Census Tract 5044.22, Santa Clara County, California",1278,43,692,107,586,104
6085504504,"Census Tract 5045.04, Santa Clara County, California",1856,144,781,112,1075,134
6085504505,"Census Tract 5045.05, Santa Clara County, California",1033,75,806,97,227,71
6085504506,"Census Tract 5045.06, Santa Clara County, California",1969,139,1103,153,866,149
6085504507,"Census Tract 5045.07, Santa Clara County, California",1682,59,1313,133,369,111
6085504601,"Census Tract 5046.01, Santa Clara County, California",462,78,282,66,180,71
6085504602,"Census Tract 5046.02, Santa Clara County, California",747,57,356,107,391,111
6085504700,"Census Tract 5047, Santa Clara County, California",47,48,0,132,47,48
6085504802,"Census Tract 5048.02, Santa Clara County, California",1554,138,1014,110,540,151
6085504803,"Census Tract 5048.03, Santa Clara County, California",2240,109,942,133,1298,143
6085504805,"Census Tract 5048.05, Santa Clara County, California",2185,87,1909,107,276,110
6085504806,"Census Tract 5048.06, Santa Clara County, California",720,28,599,61,121,60
6085504901,"Census Tract 5049.01, Santa Clara County, California",2839,134,1169,142,1670,161
6085505001,"Census Tract 5050.01, Santa Clara County, California",3025,194,1668,168,1357,209
6085505005,"Census Tract 5050.05, Santa Clara County, California",4289,204,1321,171,2968,194
6085505006,"Census Tract 5050.06, Santa Clara County, California",1846,119,668,106,1178,138
6085505007,"Census Tract 5050.07, Santa Clara County, California",931,58,589,83,342,86
6085505100,"Census Tract 5051, Santa Clara County, California",1281,63,517,89,764,86
6085505202,"Census Tract 5052.02, Santa Clara County, California",2020,129,551,156,1469,198
6085505203,"Census Tract 5052.03, Santa Clara County, California",1000,88,503,90,497,104
6085505301,"Census Tract 5053.01, Santa Clara County, California",1312,47,650,92,662,84
6085505302,"Census Tract 5053.02, Santa Clara County, California",1315,92,1049,110,266,98
6085505303,"Census Tract 5053.03, Santa Clara County, California",2094,103,795,127,1299,132
6085505304,"Census Tract 5053.04, Santa Clara County, California",1024,52,879,103,145,90
6085505305,"Census Tract 5053.05, Santa Clara County, California",1997,114,1156,148,841,169
6085505401,"Census Tract 5054.01, Santa Clara County, California",2375,103,586,156,1789,168
6085505402,"Census Tract 5054.02, Santa Clara County, California",1116,73,601,66,515,94
6085505403,"Census Tract 5054.03, Santa Clara County, California",2625,113,847,178,1778,195
6085505500,"Census Tract 5055, Santa Clara County, California",1487,109,777,127,710,132
6085505600,"Census Tract 5056, Santa Clara County, California",1108,95,288,69,820,110
6085505700,"Census Tract 5057, Santa Clara County, California",2237,87,777,135,1460,150
6085505800,"Census Tract 5058, Santa Clara County, California",1532,105,1083,114,449,109
6085505900,"Census Tract 5059, Santa Clara County, California",2944,136,1121,140,1823,168
6085506000,"Census Tract 5060, Santa Clara County, California",2018,58,858,142,1160,136
6085506101,"Census Tract 5061.01, Santa Clara County, California",1678,64,1138,103,540,101
6085506102,"Census Tract 5061.02, Santa Clara County, California",1502,53,1030,123,472,117
6085506103,"Census Tract 5061.03, Santa Clara County, California",1677,53,1057,99,620,93
6085506202,"Census Tract 5062.02, Santa Clara County, California",2507,80,1679,143,828,153
6085506203,"Census Tract 5062.03, Santa Clara County, California",2422,155,609,122,1813,177
6085506204,"Census Tract 5062.04, Santa Clara County, California",2173,68,1189,148,984,138
6085506301,"Census Tract 5063.01, Santa Clara County, California",2300,197,712,156,1588,235
6085506302,"Census Tract 5063.02, Santa Clara County, California",2423,138,1506,181,917,169
6085506304,"Census Tract 5063.04, Santa Clara County, California",2067,140,381,84,1686,150
6085506305,"Census Tract 5063.05, Santa Clara County, California",2660,77,694,195,1966,185
6085506401,"Census Tract 5064.01, Santa Clara County, California",1880,92,782,164,1098,168
6085506402,"Census Tract 5064.02, Santa Clara County, California",2214,98,568,111,1646,137
6085506501,"Census Tract 5065.01, Santa Clara County, California",2434,132,662,146,1772,155
6085506502,"Census Tract 5065.02, Santa Clara County, California",1886,123,828,137,1058,134
6085506503,"Census Tract 5065.03, Santa Clara County, California",2639,130,855,113,1784,167
6085506601,"Census Tract 5066.01, Santa Clara County, California",1660,97,869,104,791,126
6085506603,"Census Tract 5066.03, Santa Clara County, California",1448,31,1188,112,260,109
6085506604,"Census Tract 5066.04, Santa Clara County, California",2681,92,1964,201,717,191
6085506605,"Census Tract 5066.05, Santa Clara County, California",1518,67,735,87,783,101
6085506606,"Census Tract 5066.06, Santa Clara County, California",1634,94,740,94,894,119
6085506701,"Census Tract 5067.01, Santa Clara County, California",1351,63,1091,94,260,88
6085506702,"Census Tract 5067.02, Santa Clara County, California",2000,132,1193,152,807,162
6085506703,"Census Tract 5067.03, Santa Clara County, California",1324,66,832,117,492,107
6085506801,"Census Tract 5068.01, Santa Clara County, California",1971,136,1435,137,536,135
6085506802,"Census Tract 5068.02, Santa Clara County, California",1945,68,1435,109,510,99
6085506803,"Census Tract 5068.03, Santa Clara County, California",2520,72,1864,166,656,181
6085506804,"Census Tract 5068.04, Santa Clara County, California",1311,53,1122,81,189,71
6085506900,"Census Tract 5069, Santa Clara County, California",2581,115,2236,141,345,113
6085507001,"Census Tract 5070.01, Santa Clara County, California",2800,165,1846,171,954,195
6085507002,"Census Tract 5070.02, Santa Clara County, California",951,64,845,82,106,59
6085507100,"Census Tract 5071, Santa Clara County, California",1202,91,443,64,759,102
6085507203,"Census Tract 5072.03, Santa Clara County, California",857,59,498,95,359,91
6085507205,"Census Tract 5072.05, Santa Clara County, California",1761,92,1542,112,219,76
6085507206,"Census Tract 5072.06, Santa Clara County, California",905,162,749,238,156,89
6085507301,"Census Tract 5073.01, Santa Clara County, California",2392,94,1761,186,631,176
6085507302,"Census Tract 5073.02, Santa Clara County, California",954,71,826,82,128,56
6085507401,"Census Tract 5074.01, Santa Clara County, California",1844,75,1796,82,48,34
6085507402,"Census Tract 5074.02, Santa Clara County, California",1409,75,1125,74,284,87
6085507500,"Census Tract 5075, Santa Clara County, California",1956,59,1789,111,167,88
6085507600,"Census Tract 5076, Santa Clara County, California",1981,72,1674,123,307,94
6085507701,"Census Tract 5077.01, Santa Clara County, California",1243,81,1043,86,200,60
6085507702,"Census Tract 5077.02, Santa Clara County, California",1841,99,1725,119,116,76
6085507703,"Census Tract 5077.03, Santa Clara County, California",2262,126,1593,173,669,157
6085507805,"Census Tract 5078.05, Santa Clara County, California",1603,95,669,84,934,109
6085507806,"Census Tract 5078.06, Santa Clara County, California",1749,121,616,92,1133,129
6085507807,"Census Tract 5078.07, Santa Clara County, California",971,31,729,64,242,59
6085507808,"Census Tract 5078.08, Santa Clara County, California",1596,90,1273,119,323,95
6085507903,"Census Tract 5079.03, Santa Clara County, California",1668,55,1462,100,206,95
6085507904,"Census Tract 5079.04, Santa Clara County, California",1094,58,929,84,165,74
6085507905,"Census Tract 5079.05, Santa Clara County, California",2106,113,1080,153,1026,155
6085507906,"Census Tract 5079.06, Santa Clara County, California",1449,56,1198,83,251,83
6085508001,"Census Tract 5080.01, Santa Clara County, California",2507,132,1395,142,1112,156
6085508002,"Census Tract 5080.02, Santa Clara County, California",2702,152,1369,143,1333,184
6085508101,"Census Tract 5081.01, Santa Clara County, California",2171,92,1249,136,922,148
6085508102,"Census Tract 5081.02, Santa Clara County, California",1111,49,511,70,600,69
6085508202,"Census Tract 5082.02, Santa Clara County, California",2688,121,1839,184,849,190
6085508203,"Census Tract 5082.03, Santa Clara County, California",1743,46,1173,84,570,89
6085508204,"Census Tract 5082.04, Santa Clara County, California",1419,75,1123,98,296,104
6085508301,"Census Tract 5083.01, Santa Clara County, California",1438,57,1175,83,263,75
6085508303,"Census Tract 5083.03, Santa Clara County, California",842,35,774,46,68,37
6085508304,"Census Tract 5083.04, Santa Clara County, California",2531,138,968,122,1563,174
6085508401,"Census Tract 5084.01, Santa Clara County, California",2351,92,1450,140,901,136
6085508403,"Census Tract 5084.03, Santa Clara County, California",936,47,843,65,93,48
6085508404,"Census Tract 5084.04, Santa Clara County, California",2200,86,1346,100,854,110
6085508503,"Census Tract 5085.03, Santa Clara County, California",2605,132,817,169,1788,182
6085508504,"Census Tract 5085.04, Santa Clara County, California",2944,127,410,111,2534,149
6085508505,"Census Tract 5085.05, Santa Clara County, California",1797,75,1013,115,784,109
6085508506,"Census Tract 5085.06, Santa Clara County, California",3238,96,986,160,2252,166
6085508601,"Census Tract 5086.01, Santa Clara County, California",1298,74,784,103,514,109
6085508602,"Census Tract 5086.02, Santa Clara County, California",1695,72,596,109,1099,108
6085508703,"Census Tract 5087.03, Santa Clara County, California",2716,148,1166,155,1550,166
6085508704,"Census Tract 5087.04, Santa Clara County, California",2129,135,330,89,1799,174
6085508800,"Census Tract 5088, Santa Clara County, California",1335,80,485,109,850,125
6085508900,"Census Tract 5089, Santa Clara County, California",1683,72,792,106,891,116
6085509000,"Census Tract 5090, Santa Clara County, California",2392,83,1254,138,1138,122
6085509102,"Census Tract 5091.02, Santa Clara County, California",2139,124,857,140,1282,171
6085509105,"Census Tract 5091.05, Santa Clara County, California",2664,124,927,119,1737,154
6085509106,"Census Tract 5091.06, Santa Clara County, California",1515,93,484,86,1031,110
6085509107,"Census Tract 5091.07, Santa Clara County, California",2002,79,56,35,1946,88
6085509108,"Census Tract 5091.08, Santa Clara County, California",1645,133,544,115,1101,128
6085509109,"Census Tract 5091.09, Santa Clara County, California",1853,119,939,144,914,137
6085509201,"Census Tract 5092.01, Santa Clara County, California",2097,153,932,157,1165,155
6085509202,"Census Tract 5092.02, Santa Clara County, California",1674,110,724,112,950,119
6085509302,"Census Tract 5093.02, Santa Clara County, California",1012,44,691,80,321,75
6085509303,"Census Tract 5093.03, Santa Clara County, California",1641,80,474,101,1167,107
6085509304,"Census Tract 5093.04, Santa Clara County, California",1141,59,457,76,684,84
6085509401,"Census Tract 5094.01, Santa Clara County, California",1460,104,297,70,1163,128
6085509403,"Census Tract 5094.03, Santa Clara County, California",1966,103,199,76,1767,130
6085509404,"Census Tract 5094.04, Santa Clara County, California",2734,93,1076,174,1658,185
6085509500,"Census Tract 5095, Santa Clara County, California",2137,130,473,137,1664,153
6085509600,"Census Tract 5096, Santa Clara County, California",1332,95,443,84,889,110
6085509700,"Census Tract 5097, Santa Clara County, California",1384,62,599,87,785,102
6085509801,"Census Tract 5098.01, Santa Clara County, California",2075,92,1157,134,918,138
6085509802,"Census Tract 5098.02, Santa Clara County, California",1050,69,649,96,401,108
6085509901,"Census Tract 5099.01, Santa Clara County, California",642,55,552,62,90,43
6085509902,"Census Tract 5099.02, Santa Clara County, California",1721,89,1237,117,484,106
6085510001,"Census Tract 5100.01, Santa Clara County, California",2005,66,1892,89,113,66
6085510002,"Census Tract 5100.02, Santa Clara County, California",1226,50,1069,74,157,73
6085510100,"Census Tract 5101, Santa Clara County, California",1065,32,1014,50,51,36
6085510200,"Census Tract 5102, Santa Clara County, California",1471,37,1415,55,56,36
6085510300,"Census Tract 5103, Santa Clara County, California",1534,94,1162,117,372,106
6085510400,"Census Tract 5104, Santa Clara County, California",1117,29,1002,53,115,44
6085510500,"Census Tract 5105, Santa Clara County, California",1628,78,1267,96,361,88
6085510600,"Census Tract 5106, Santa Clara County, California",2078,94,1256,145,822,150
6085510700,"Census Tract 5107, Santa Clara County, California",1628,90,698,102,930,125
6085510801,"Census Tract 5108.01, Santa Clara County, California",1527,69,1380,89,147,61
6085510802,"Census Tract 5108.02, Santa Clara County, California",832,28,478,67,354,68
6085510803,"Census Tract 5108.03, Santa Clara County, California",919,63,505,68,414,83
6085510900,"Census Tract 5109, Santa Clara County, California",1754,95,1107,112,647,131
6085511000,"Census Tract 5110, Santa Clara County, California",2090,108,1303,116,787,123
6085511100,"Census Tract 5111, Santa Clara County, California",1740,62,1534,96,206,79
6085511200,"Census Tract 5112, Santa Clara County, California",1621,69,1374,84,247,76
6085511300,"Census Tract 5113, Santa Clara County, California",3612,182,1444,184,2168,219
6085511400,"Census Tract 5114, Santa Clara County, California",1249,63,931,64,318,76
6085511500,"Census Tract 5115, Santa Clara County, California",2616,123,1575,147,1041,168
6085511604,"Census Tract 5116.04, Santa Clara County, California",1726,127,185,63,1541,134
6085511605,"Census Tract 5116.05, Santa Clara County, California",142,53,0,132,142,53
6085511606,"Census Tract 5116.06, Santa Clara County, California",1529,180,0,132,1529,180
6085511607,"Census Tract 5116.07, Santa Clara County, California",477,73,0,132,477,73
6085511701,"Census Tract 5117.01, Santa Clara County, California",1348,98,1229,104,119,66
6085511702,"Census Tract 5117.02, Santa Clara County, California",908,61,857,63,51,39
6085511703,"Census Tract 5117.03, Santa Clara County, California",2921,143,2651,174,270,106
6085511800,"Census Tract 5118, Santa Clara County, California",1505,108,1187,115,318,99
6085511901,"Census Tract 5119.01, Santa Clara County, California",2996,108,1685,177,1311,193
6085511905,"Census Tract 5119.05, Santa Clara County, California",1113,23,925,79,188,81
6085511907,"Census Tract 5119.07, Santa Clara County, California",1362,33,1240,66,122,55
6085511909,"Census Tract 5119.09, Santa Clara County, California",2706,62,2656,74,50,42
6085511910,"Census Tract 5119.10, Santa Clara County, California",1093,40,1014,61,79,50
6085511911,"Census Tract 5119.11, Santa Clara County, California",1782,72,1448,99,334,89
6085511912,"Census Tract 5119.12, Santa Clara County, California",1803,44,1490,129,313,120
6085511913,"Census Tract 5119.13, Santa Clara County, California",1480,37,1439,52,41,36
6085511914,"Census Tract 5119.14, Santa Clara County, California",1960,62,1782,93,178,83
6085512001,"Census Tract 5120.01, Santa Clara County, California",2023,43,1805,87,218,77
6085512002,"Census Tract 5120.02, Santa Clara County, California",2442,111,1816,175,626,157
6085512005,"Census Tract 5120.05, Santa Clara County, California",2240,68,1852,160,388,153
6085512014,"Census Tract 5120.14, Santa Clara County, California",1889,46,1612,126,277,122
6085512015,"Census Tract 5120.15, Santa Clara County, California",1783,40,1477,96,306,91
6085512016,"Census Tract 5120.16, Santa Clara County, California",3311,127,1940,178,1371,196
6085512017,"Census Tract 5120.17, Santa Clara County, California",1897,103,1274,158,623,147
6085512018,"Census Tract 5120.18, Santa Clara County, California",2571,104,1095,174,1476,162
6085512019,"Census Tract 5120.19, Santa Clara County, California",1815,41,1203,105,612,112
6085512020,"Census Tract 5120.20, Santa Clara County, California",2799,103,271,83,2528,124
6085512021,"Census Tract 5120.21, Santa Clara County, California",2104,67,1764,149,340,142
6085512022,"Census Tract 5120.22, Santa Clara County, California",1812,79,1113,134,699,122
6085512023,"Census Tract 5120.23, Santa Clara County, California",1975,74,1341,160,634,161
6085512024,"Census Tract 5120.24, Santa Clara County, California",1662,90,1017,113,645,107
6085512025,"Census Tract 5120.25, Santa Clara County, California",867,16,822,39,45,36
6085512026,"Census Tract 5120.26, Santa Clara County, California",1633,30,1160,148,473,143
6085512027,"Census Tract 5120.27, Santa Clara County, California",1618,65,569,101,1049,107
6085512028,"Census Tract 5120.28, Santa Clara County, California",2706,105,1651,170,1055,165
6085512029,"Census Tract 5120.29, Santa Clara County, California",2382,67,2021,180,361,175
6085512030,"Census Tract 5120.30, Santa Clara County, California",951,56,906,59,45,34
6085512031,"Census Tract 5120.31, Santa Clara County, California",1354,61,1149,96,205,84
6085512032,"Census Tract 5120.32, Santa Clara County, California",1075,32,898,91,177,90
6085512033,"Census Tract 5120.33, Santa Clara County, California",1971,114,1557,153,414,143
6085512034,"Census Tract 5120.34, Santa Clara County, California",1070,23,900,86,170,83
6085512035,"Census Tract 5120.35, Santa Clara County, California",1394,53,1117,84,277,91
6085512100,"Census Tract 5121, Santa Clara County, California",496,72,407,66,89,58
6085512200,"Census Tract 5122, Santa Clara County, California",1537,110,1345,126,192,76
6085512304,"Census Tract 5123.04, Santa Clara County, California",3135,184,2440,178,695,173
6085512305,"Census Tract 5123.05, Santa Clara County, California",1205,79,1076,85,129,61
6085512306,"Census Tract 5123.06, Santa Clara County, California",3090,157,1554,216,1536,224
6085512307,"Census Tract 5123.07, Santa Clara County, California",2164,163,1785,172,379,123
6085512308,"Census Tract 5123.08, Santa Clara County, California",2001,114,1854,118,147,87
6085512309,"Census Tract 5123.09, Santa Clara County, California",1684,97,1486,149,198,117
6085512401,"Census Tract 5124.01, Santa Clara County, California",1298,71,983,128,315,111
6085512402,"Census Tract 5124.02, Santa Clara County, California",1328,122,1258,117,70,41
6085512503,"Census Tract 5125.03, Santa Clara County, California",2529,101,2280,152,249,123
6085512505,"Census Tract 5125.05, Santa Clara County, California",2164,105,1173,142,991,143
6085512506,"Census Tract 5125.06, Santa Clara County, California",1787,91,949,165,838,149
6085512507,"Census Tract 5125.07, Santa Clara County, California",2966,177,2122,204,844,204
6085512508,"Census Tract 5125.08, Santa Clara County, California",2621,146,1650,225,971,180
6085512601,"Census Tract 5126.01, Santa Clara County, California",2126,114,729,120,1397,147
6085512602,"Census Tract 5126.02, Santa Clara County, California",637,95,416,82,221,86
6085512700,"Census Tract 5127, Santa Clara County, California",276,54,233,44,43,45
6087100100,"Census Tract 1001, Santa Cruz County, California",911,53,726,77,185,90
6087100200,"Census Tract 1002, Santa Cruz County, California",2685,146,1447,158,1238,178
6087100300,"Census Tract 1003, Santa Cruz County, California",1199,62,656,94,543,97
6087100400,"Census Tract 1004, Santa Cruz County, California",456,52,175,53,281,63
6087100500,"Census Tract 1005, Santa Cruz County, California",1926,168,1100,119,826,168
6087100600,"Census Tract 1006, Santa Cruz County, California",1204,111,665,95,539,133
6087100700,"Census Tract 1007, Santa Cruz County, California",913,76,283,75,630,94
6087100800,"Census Tract 1008, Santa Cruz County, California",3070,142,810,173,2260,207
6087100900,"Census Tract 1009, Santa Cruz County, California",1826,160,703,149,1123,156
6087101000,"Census Tract 1010, Santa Cruz County, California",3535,222,440,111,3095,220
6087101100,"Census Tract 1011, Santa Cruz County, California",2320,105,1443,130,877,162
6087101200,"Census Tract 1012, Santa Cruz County, California",1244,94,800,105,444,120
6087110100,"Census Tract 1101, Santa Cruz County, California",2521,146,1295,184,1226,195
6087110200,"Census Tract 1102, Santa Cruz County, California",2241,150,1384,166,857,154
6087110300,"Census Tract 1103, Santa Cruz County, California",1751,130,320,100,1431,148
6087110400,"Census Tract 1104, Santa Cruz County, California",1851,111,802,133,1049,127
6087110501,"Census Tract 1105.01, Santa Cruz County, California",1935,125,919,149,1016,142
6087110502,"Census Tract 1105.02, Santa Cruz County, California",1492,109,1059,146,433,115
6087110600,"Census Tract 1106, Santa Cruz County, California",2142,126,1218,155,924,146
6087110700,"Census Tract 1107, Santa Cruz County, California",846,56,609,102,237,87
6087120200,"Census Tract 1202, Santa Cruz County, California",1576,76,1105,92,471,99
6087120301,"Census Tract 1203.01, Santa Cruz County, California",2014,152,1547,162,467,132
6087120302,"Census Tract 1203.02, Santa Cruz County, California",1059,83,645,97,414,92
6087120400,"Census Tract 1204, Santa Cruz County, California",2233,153,1485,173,748,213
6087120500,"Census Tract 1205, Santa Cruz County, California",2700,139,2155,163,545,149
6087120600,"Census Tract 1206, Santa Cruz County, California",1882,83,1548,116,334,97
6087120700,"Census Tract 1207, Santa Cruz County, California",1559,146,1223,139,336,104
6087120800,"Census Tract 1208, Santa Cruz County, California",2474,120,1913,147,561,136
6087120900,"Census Tract 1209, Santa Cruz County, California",3018,236,2274,232,744,169
6087121000,"Census Tract 1210, Santa Cruz County, California",1348,102,1111,139,237,115
6087121100,"Census Tract 1211, Santa Cruz County, California",1146,66,1032,77,114,41
6087121200,"Census Tract 1212, Santa Cruz County, California",2503,71,1915,146,588,147
6087121300,"Census Tract 1213, Santa Cruz County, California",1552,96,864,93,688,114
6087121401,"Census Tract 1214.01, Santa Cruz County, California",864,37,560,84,304,83
6087121402,"Census Tract 1214.02, Santa Cruz County, California",1468,64,814,115,654,110
6087121403,"Census Tract 1214.03, Santa Cruz County, California",1252,100,615,111,637,110
6087121500,"Census Tract 1215, Santa Cruz County, California",2378,159,771,156,1607,190
6087121600,"Census Tract 1216, Santa Cruz County, California",2607,223,1528,181,1079,192
6087121700,"Census Tract 1217, Santa Cruz County, California",3022,180,1660,205,1362,196
6087121800,"Census Tract 1218, Santa Cruz County, California",2315,173,883,174,1432,186
6087122001,"Census Tract 1220.01, Santa Cruz County, California",1823,90,1314,127,509,129
6087122002,"Census Tract 1220.02, Santa Cruz County, California",1356,69,1127,98,229,95
6087122003,"Census Tract 1220.03, Santa Cruz County, California",2646,127,1854,161,792,183
6087122100,"Census Tract 1221, Santa Cruz County, California",1342,123,743,122,599,117
6087122201,"Census Tract 1222.01, Santa Cruz County, California",2729,183,2121,168,608,154
6087122202,"Census Tract 1222.02, Santa Cruz County, California",793,68,726,72,67,47
6087122203,"Census Tract 1222.03, Santa Cruz County, California",1554,97,1021,107,533,97
6087122300,"Census Tract 1223, Santa Cruz County, California",1483,118,873,121,610,135
6087122400,"Census Tract 1224, Santa Cruz County, California",2467,121,1902,159,565,153
6087122500,"Census Tract 1225, Santa Cruz County, California",1329,88,940,97,389,127
6087123100,"Census Tract 1231, Santa Cruz County, California",758,67,651,77,107,57
6087123300,"Census Tract 1233, Santa Cruz County, California",436,38,182,48,254,58
6089010100,"Census Tract 101, Shasta County, California",720,111,185,104,535,112
6089010200,"Census Tract 102, Shasta County, California",1173,64,478,101,695,101
6089010300,"Census Tract 103, Shasta County, California",1696,76,820,124,876,129
6089010400,"Census Tract 104, Shasta County, California",1519,102,936,134,583,141
6089010500,"Census Tract 105, Shasta County, California",1896,148,830,130,1066,184
6089010600,"Census Tract 106, Shasta County, California",3600,143,2720,197,880,207
6089010701,"Census Tract 107.01, Shasta County, California",3591,168,1731,165,1860,208
6089010702,"Census Tract 107.02, Shasta County, California",1521,135,905,115,616,128
6089010801,"Census Tract 108.01, Shasta County, California",3036,182,2123,203,913,193
6089010802,"Census Tract 108.02, Shasta County, California",4479,193,2571,243,1908,239
6089010900,"Census Tract 109, Shasta County, California",1573,145,656,105,917,151
6089011000,"Census Tract 110, Shasta County, California",2928,116,2120,186,808,176
6089011100,"Census Tract 111, Shasta County, California",1088,67,781,98,307,91
6089011200,"Census Tract 112, Shasta County, California",2186,186,723,144,1463,211
6089011300,"Census Tract 113, Shasta County, California",2145,116,1133,128,1012,169
6089011400,"Census Tract 114, Shasta County, California",3564,138,2684,240,880,223
6089011500,"Census Tract 115, Shasta County, California",2343,120,2011,152,332,138
6089011600,"Census Tract 116, Shasta County, California",1540,103,1024,119,516,120
6089011700,"Census Tract 117, Shasta County, California",3160,198,2181,229,979,202
6089011800,"Census Tract 118, Shasta County, California",3012,169,2632,177,380,162
6089011900,"Census Tract 119, Shasta County, California",1770,95,1493,109,277,106
6089012000,"Census Tract 120, Shasta County, California",2014,157,828,136,1186,161
6089012100,"Census Tract 121, Shasta County, California",2743,160,1569,251,1174,200
6089012200,"Census Tract 122, Shasta County, California",1897,132,1433,139,464,115
6089012301,"Census Tract 123.01, Shasta County, California",964,125,711,131,253,110
6089012302,"Census Tract 123.02, Shasta County, California",1955,113,1493,134,462,113
6089012303,"Census Tract 123.03, Shasta County, California",1382,107,1046,130,336,117
6089012400,"Census Tract 124, Shasta County, California",1505,99,1271,93,234,70
6089012500,"Census Tract 125, Shasta County, California",608,84,552,88,56,32
6089012601,"Census Tract 126.01, Shasta County, California",1913,110,1532,118,381,97
6089012602,"Census Tract 126.02, Shasta County, California",2582,195,2155,166,427,165
6089012701,"Census Tract 127.01, Shasta County, California",1987,171,1488,202,499,158
6089012702,"Census Tract 127.02, Shasta County, California",1381,132,1071,161,310,135
6091010000,"Census Tract 100, Sierra County, California",1403,149,1037,155,366,107
6093000100,"Census Tract 1, Siskiyou County, California",570,61,298,63,272,63
6093000200,"Census Tract 2, Siskiyou County, California",750,69,522,78,228,64
6093000300,"Census Tract 3, Siskiyou County, California",1693,100,1227,101,466,88
6093000400,"Census Tract 4, Siskiyou County, California",369,41,251,46,118,44
6093000500,"Census Tract 5, Siskiyou County, California",962,81,647,65,315,58
6093000600,"Census Tract 6, Siskiyou County, California",686,75,536,73,150,52
6093000701,"Census Tract 7.01, Siskiyou County, California",1549,94,1316,95,233,73
6093000702,"Census Tract 7.02, Siskiyou County, California",1964,153,911,137,1053,158
6093000703,"Census Tract 7.03, Siskiyou County, California",1564,142,1057,131,507,146
6093000800,"Census Tract 8, Siskiyou County, California",1400,119,1126,123,274,76
6093000900,"Census Tract 9, Siskiyou County, California",3139,300,2144,229,995,236
6093001000,"Census Tract 10, Siskiyou County, California",3216,246,2111,231,1105,206
6093001100,"Census Tract 11, Siskiyou County, California",1238,111,687,95,551,118
6093001200,"Census Tract 12, Siskiyou County, California",738,83,469,67,269,65
6095250101,"Census Tract 2501.01, Solano County, California",2400,102,1499,200,901,187
6095250102,"Census Tract 2501.02, Solano County, California",3298,153,2595,213,703,197
6095250200,"Census Tract 2502, Solano County, California",1315,113,886,112,429,144
6095250300,"Census Tract 2503, Solano County, California",1062,141,811,150,251,95
6095250400,"Census Tract 2504, Solano County, California",1244,90,914,127,330,117
6095250501,"Census Tract 2505.01, Solano County, California",780,37,579,76,201,69
6095250502,"Census Tract 2505.02, Solano County, California",1125,55,850,115,275,106
6095250601,"Census Tract 2506.01, Solano County, California",1466,83,1214,112,252,101
6095250603,"Census Tract 2506.03, Solano County, California",2767,121,2373,173,394,144
6095250701,"Census Tract 2507.01, Solano County, California",1006,103,665,100,341,111
6095250702,"Census Tract 2507.02, Solano County, California",1213,124,456,96,757,130
6095250800,"Census Tract 2508, Solano County, California",110,52,78,38,32,53
6095250900,"Census Tract 2509, Solano County, California",1343,109,123,53,1220,106
6095251000,"Census Tract 2510, Solano County, California",1013,119,372,89,641,119
6095251100,"Census Tract 2511, Solano County, California",1065,104,510,103,555,125
6095251200,"Census Tract 2512, Solano County, California",1218,75,627,119,591,134
6095251300,"Census Tract 2513, Solano County, California",1196,81,998,109,198,85
6095251400,"Census Tract 2514, Solano County, California",2026,154,1519,166,507,142
6095251500,"Census Tract 2515, Solano County, California",1339,101,536,150,803,147
6095251600,"Census Tract 2516, Solano County, California",1036,129,274,85,762,127
6095251701,"Census Tract 2517.01, Solano County, California",1386,102,541,83,845,131
6095251702,"Census Tract 2517.02, Solano County, California",811,95,619,120,192,99
6095251802,"Census Tract 2518.02, Solano County, California",1186,150,436,98,750,160
6095251803,"Census Tract 2518.03, Solano County, California",1302,110,1009,142,293,110
6095251804,"Census Tract 2518.04, Solano County, California",940,56,642,98,298,88
6095251901,"Census Tract 2519.01, Solano County, California",1765,124,952,164,813,160
6095251902,"Census Tract 2519.02, Solano County, California",1596,94,1235,127,361,105
6095251903,"Census Tract 2519.03, Solano County, California",1314,128,993,123,321,118
6095252000,"Census Tract 2520, Solano County, California",2046,122,1122,127,924,158
6095252102,"Census Tract 2521.02, Solano County, California",1473,125,888,122,585,123
6095252103,"Census Tract 2521.03, Solano County, California",1912,128,1034,119,878,145
6095252104,"Census Tract 2521.04, Solano County, California",1564,99,1502,95,62,37
6095252105,"Census Tract 2521.05, Solano County, California",1187,90,1036,93,151,71
6095252106,"Census Tract 2521.06, Solano County, California",1682,100,1047,98,635,108
6095252107,"Census Tract 2521.07, Solano County, California",1391,88,989,128,402,107
6095252108,"Census Tract 2521.08, Solano County, California",1192,86,896,104,296,96
6095252201,"Census Tract 2522.01, Solano County, California",2811,137,2576,144,235,96
6095252202,"Census Tract 2522.02, Solano County, California",2932,135,2541,180,391,151
6095252305,"Census Tract 2523.05, Solano County, California",1508,69,1136,89,372,88
6095252306,"Census Tract 2523.06, Solano County, California",1187,82,940,95,247,74
6095252307,"Census Tract 2523.07, Solano County, California",3845,190,3014,186,831,218
6095252308,"Census Tract 2523.08, Solano County, California",3254,186,1870,212,1384,212
6095252309,"Census Tract 2523.09, Solano County, California",4209,200,3433,249,776,215
6095252401,"Census Tract 2524.01, Solano County, California",1220,102,805,113,415,120
6095252402,"Census Tract 2524.02, Solano County, California",1566,104,887,132,679,124
6095252501,"Census Tract 2525.01, Solano County, California",934,74,402,82,532,96
6095252502,"Census Tract 2525.02, Solano County, California",590,66,149,53,441,70
6095252604,"Census Tract 2526.04, Solano County, California",1108,112,501,83,607,121
6095252605,"Census Tract 2526.05, Solano County, California",1890,87,688,127,1202,118
6095252606,"Census Tract 2526.06, Solano County, California",1638,91,717,112,921,119
6095252607,"Census Tract 2526.07, Solano County, California",1166,61,424,94,742,100
6095252608,"Census Tract 2526.08, Solano County, California",1285,103,592,113,693,138
6095252609,"Census Tract 2526.09, Solano County, California",2104,136,1416,173,688,159
6095252702,"Census Tract 2527.02, Solano County, California",2186,144,1642,152,544,128
6095252703,"Census Tract 2527.03, Solano County, California",1170,112,827,126,343,149
6095252704,"Census Tract 2527.04, Solano County, California",1318,100,871,106,447,105
6095252705,"Census Tract 2527.05, Solano County, California",1801,112,1409,161,392,139
6095252706,"Census Tract 2527.06, Solano County, California",1056,70,917,99,139,79
6095252707,"Census Tract 2527.07, Solano County, California",1551,141,969,100,582,129
6095252800,"Census Tract 2528, Solano County, California",1033,151,23,26,1010,154
6095252902,"Census Tract 2529.02, Solano County, California",4616,176,3283,216,1333,197
6095252903,"Census Tract 2529.03, Solano County, California",1557,136,1257,140,300,114
6095252904,"Census Tract 2529.04, Solano County, California",1481,126,987,144,494,124
6095252907,"Census Tract 2529.07, Solano County, California",4313,164,3189,211,1124,201
6095252908,"Census Tract 2529.08, Solano County, California",1269,95,732,113,537,142
6095252909,"Census Tract 2529.09, Solano County, California",1031,68,850,91,181,65
6095252910,"Census Tract 2529.10, Solano County, California",1913,87,1343,139,570,120
6095253000,"Census Tract 2530, Solano County, California",0,132,0,132,0,132
6095253101,"Census Tract 2531.01, Solano County, California",2037,124,1339,172,698,154
6095253105,"Census Tract 2531.05, Solano County, California",2302,159,916,157,1386,201
6095253106,"Census Tract 2531.06, Solano County, California",1204,81,558,83,646,100
6095253107,"Census Tract 2531.07, Solano County, California",2159,175,1168,151,991,165
6095253108,"Census Tract 2531.08, Solano County, California",1325,109,786,147,539,157
6095253201,"Census Tract 2532.01, Solano County, California",1823,65,1646,97,177,71
6095253202,"Census Tract 2532.02, Solano County, California",4141,186,3032,209,1109,237
6095253203,"Census Tract 2532.03, Solano County, California",1516,88,956,128,560,135
6095253300,"Census Tract 2533, Solano County, California",856,99,628,88,228,77
6095253401,"Census Tract 2534.01, Solano County, California",3237,152,2278,182,959,191
6095253402,"Census Tract 2534.02, Solano County, California",2094,124,1173,157,921,153
6095253500,"Census Tract 2535, Solano County, California",3901,246,3044,266,857,209
6097150100,"Census Tract 1501, Sonoma County, California",1109,90,769,105,340,115
6097150201,"Census Tract 1502.01, Sonoma County, California",3525,252,2192,219,1333,224
6097150202,"Census Tract 1502.02, Sonoma County, California",2174,165,1464,157,710,163
6097150302,"Census Tract 1503.02, Sonoma County, California",2968,220,1792,213,1176,231
6097150303,"Census Tract 1503.03, Sonoma County, California",2198,139,1877,192,321,192
6097150304,"Census Tract 1503.04, Sonoma County, California",2141,176,1293,186,848,178
6097150500,"Census Tract 1505, Sonoma County, California",1930,173,1236,200,694,179
6097150601,"Census Tract 1506.01, Sonoma County, California",1274,84,975,111,299,90
6097150602,"Census Tract 1506.02, Sonoma County, California",1418,76,1141,118,277,100
6097150603,"Census Tract 1506.03, Sonoma County, California",2628,130,1759,162,869,164
6097150605,"Census Tract 1506.05, Sonoma County, California",4887,163,3961,260,926,190
6097150606,"Census Tract 1506.06, Sonoma County, California",2811,159,1808,191,1003,181
6097150701,"Census Tract 1507.01, Sonoma County, California",1961,91,878,131,1083,147
6097150702,"Census Tract 1507.02, Sonoma County, California",1639,89,1283,120,356,111
6097150800,"Census Tract 1508, Sonoma County, California",1861,127,1035,108,826,144
6097150901,"Census Tract 1509.01, Sonoma County, California",1798,103,895,121,903,153
6097150902,"Census Tract 1509.02, Sonoma County, California",1254,84,1025,94,229,80
6097151000,"Census Tract 1510, Sonoma County, California",1393,101,943,116,450,109
6097151100,"Census Tract 1511, Sonoma County, California",1700,103,1020,114,680,93
6097151201,"Census Tract 1512.01, Sonoma County, California",2545,150,1721,177,824,150
6097151203,"Census Tract 1512.03, Sonoma County, California",2048,124,1180,157,868,114
6097151204,"Census Tract 1512.04, Sonoma County, California",1624,113,1018,128,606,136
6097151301,"Census Tract 1513.01, Sonoma County, California",1605,83,766,102,839,89
6097151305,"Census Tract 1513.05, Sonoma County, California",2337,140,781,171,1556,172
6097151306,"Census Tract 1513.06, Sonoma County, California",1579,95,951,123,628,138
6097151307,"Census Tract 1513.07, Sonoma County, California",1910,155,1507,186,403,139
6097151308,"Census Tract 1513.08, Sonoma County, California",1983,99,1168,89,815,90
6097151309,"Census Tract 1513.09, Sonoma County, California",1769,105,1347,139,422,106
6097151310,"Census Tract 1513.10, Sonoma County, California",1495,83,717,105,778,122
6097151311,"Census Tract 1513.11, Sonoma County, California",2426,97,1375,181,1051,186
6097151401,"Census Tract 1514.01, Sonoma County, California",1841,121,791,127,1050,168
6097151402,"Census Tract 1514.02, Sonoma County, California",3263,159,1363,207,1900,222
6097151502,"Census Tract 1515.02, Sonoma County, California",3027,102,1614,201,1413,197
6097151503,"Census Tract 1515.03, Sonoma County, California",1389,59,1283,81,106,72
6097151504,"Census Tract 1515.04, Sonoma County, California",1319,46,1096,84,223,82
6097151600,"Census Tract 1516, Sonoma County, California",3595,163,2794,222,801,172
6097151700,"Census Tract 1517, Sonoma County, California",2748,180,1325,188,1423,190
6097151800,"Census Tract 1518, Sonoma County, California",2074,99,1251,145,823,164
6097151900,"Census Tract 1519, Sonoma County, California",1272,125,443,91,829,163
6097152000,"Census Tract 1520, Sonoma County, California",863,93,117,61,746,113
6097152100,"Census Tract 1521, Sonoma County, California",909,108,499,114,410,91
6097152201,"Census Tract 1522.01, Sonoma County, California",1585,128,501,101,1084,149
6097152202,"Census Tract 1522.02, Sonoma County, California",2782,127,1545,177,1237,174
6097152203,"Census Tract 1522.03, Sonoma County, California",1837,64,869,114,968,128
6097152300,"Census Tract 1523, Sonoma County, California",1906,54,1388,106,518,107
6097152400,"Census Tract 1524, Sonoma County, California",3786,112,2937,198,849,201
6097152501,"Census Tract 1525.01, Sonoma County, California",1699,75,664,101,1035,109
6097152502,"Census Tract 1525.02, Sonoma County, California",1484,55,988,110,496,107
6097152600,"Census Tract 1526, Sonoma County, California",3099,137,2734,172,365,144
6097152701,"Census Tract 1527.01, Sonoma County, California",1970,164,1598,169,372,137
6097152702,"Census Tract 1527.02, Sonoma County, California",1872,107,1130,97,742,126
6097152801,"Census Tract 1528.01, Sonoma County, California",1853,86,1281,135,572,127
6097152802,"Census Tract 1528.02, Sonoma County, California",2591,159,602,102,1989,188
6097152901,"Census Tract 1529.01, Sonoma County, California",3090,159,2026,233,1064,232
6097152903,"Census Tract 1529.03, Sonoma County, California",1441,60,562,106,879,113
6097152904,"Census Tract 1529.04, Sonoma County, California",1700,114,1049,98,651,131
6097153001,"Census Tract 1530.01, Sonoma County, California",2073,101,736,129,1337,128
6097153002,"Census Tract 1530.02, Sonoma County, California",1830,131,1169,145,661,161
6097153003,"Census Tract 1530.03, Sonoma County, California",1955,90,967,148,988,146
6097153005,"Census Tract 1530.05, Sonoma County, California",2395,115,1830,160,565,160
6097153006,"Census Tract 1530.06, Sonoma County, California",2479,154,1746,183,733,177
6097153101,"Census Tract 1531.01, Sonoma County, California",2681,107,1012,161,1669,194
6097153102,"Census Tract 1531.02, Sonoma County, California",1405,64,590,101,815,98
6097153200,"Census Tract 1532, Sonoma County, California",1970,108,1226,138,744,131
6097153300,"Census Tract 1533, Sonoma County, California",2985,237,2015,239,970,230
6097153401,"Census Tract 1534.01, Sonoma County, California",2443,161,1345,172,1098,160
6097153403,"Census Tract 1534.03, Sonoma County, California",1581,109,1001,126,580,128
6097153404,"Census Tract 1534.04, Sonoma County, California",1711,98,1161,115,550,121
6097153501,"Census Tract 1535.01, Sonoma County, California",1773,124,1512,137,261,97
6097153502,"Census Tract 1535.02, Sonoma County, California",1475,123,1165,142,310,105
6097153600,"Census Tract 1536, Sonoma County, California",2102,181,1715,199,387,118
6097153703,"Census Tract 1537.03, Sonoma County, California",1646,155,935,135,711,141
6097153704,"Census Tract 1537.04, Sonoma County, California",2000,219,1180,207,820,212
6097153705,"Census Tract 1537.05, Sonoma County, California",1511,118,1114,136,397,118
6097153706,"Census Tract 1537.06, Sonoma County, California",1955,179,1539,167,416,132
6097153801,"Census Tract 1538.01, Sonoma County, California",2927,123,2359,184,568,141
6097153802,"Census Tract 1538.02, Sonoma County, California",3300,185,2504,215,796,199
6097153803,"Census Tract 1538.03, Sonoma County, California",2934,181,1940,234,994,169
6097153901,"Census Tract 1539.01, Sonoma County, California",2405,135,1575,153,830,153
6097153902,"Census Tract 1539.02, Sonoma County, California",1516,108,716,87,800,124
6097153903,"Census Tract 1539.03, Sonoma County, California",1496,133,967,117,529,124
6097154000,"Census Tract 1540, Sonoma County, California",1041,98,684,77,357,88
6097154100,"Census Tract 1541, Sonoma County, California",1574,96,1150,124,424,107
6097154200,"Census Tract 1542, Sonoma County, California",3757,266,2299,198,1458,249
6097154301,"Census Tract 1543.01, Sonoma County, California",1608,123,1208,124,400,84
6097154302,"Census Tract 1543.02, Sonoma County, California",1548,175,1216,157,332,117
6099000101,"Census Tract 1.01, Stanislaus County, California",1846,84,1506,112,340,93
6099000102,"Census Tract 1.02, Stanislaus County, California",1338,85,1125,105,213,94
6099000201,"Census Tract 2.01, Stanislaus County, California",2306,128,1767,170,539,121
6099000202,"Census Tract 2.02, Stanislaus County, California",1404,115,846,111,558,103
6099000203,"Census Tract 2.03, Stanislaus County, California",3273,164,2025,227,1248,237
6099000301,"Census Tract 3.01, Stanislaus County, California",621,59,302,70,319,69
6099000302,"Census Tract 3.02, Stanislaus County, California",785,82,454,68,331,104
6099000303,"Census Tract 3.03, Stanislaus County, California",1482,97,1269,106,213,76
6099000304,"Census Tract 3.04, Stanislaus County, California",1294,73,850,159,444,134
6099000402,"Census Tract 4.02, Stanislaus County, California",2918,134,2503,156,415,163
6099000403,"Census Tract 4.03, Stanislaus County, California",1485,84,1174,109,311,96
6099000404,"Census Tract 4.04, Stanislaus County, California",2129,114,1473,161,656,159
6099000501,"Census Tract 5.01, Stanislaus County, California",2434,139,2100,169,334,140
6099000503,"Census Tract 5.03, Stanislaus County, California",1711,95,948,113,763,150
6099000504,"Census Tract 5.04, Stanislaus County, California",2970,134,2063,188,907,188
6099000505,"Census Tract 5.05, Stanislaus County, California",1476,101,888,141,588,138
6099000506,"Census Tract 5.06, Stanislaus County, California",1775,100,1049,117,726,118
6099000507,"Census Tract 5.07, Stanislaus County, California",2422,132,1863,206,559,199
6099000508,"Census Tract 5.08, Stanislaus County, California",1205,74,759,94,446,92
6099000601,"Census Tract 6.01, Stanislaus County, California",1465,67,1190,102,275,84
6099000602,"Census Tract 6.02, Stanislaus County, California",847,48,635,75,212,70
6099000801,"Census Tract 8.01, Stanislaus County, California",2487,144,1625,153,862,169
6099000803,"Census Tract 8.03, Stanislaus County, California",1320,170,823,131,497,128
6099000805,"Census Tract 8.05, Stanislaus County, California",1993,103,1454,163,539,162
6099000806,"Census Tract 8.06, Stanislaus County, California",1529,82,825,115,704,108
6099000807,"Census Tract 8.07, Stanislaus County, California",1556,72,433,82,1123,105
6099000905,"Census Tract 9.05, Stanislaus County, California",2023,104,1468,124,555,120
6099000906,"Census Tract 9.06, Stanislaus County, California",2214,117,1529,133,685,143
6099000907,"Census Tract 9.07, Stanislaus County, California",1262,59,1033,78,229,72
6099000908,"Census Tract 9.08, Stanislaus County, California",1844,123,1008,108,836,119
6099000909,"Census Tract 9.09, Stanislaus County, California",1722,80,883,113,839,124
6099000910,"Census Tract 9.10, Stanislaus County, California",2366,138,915,192,1451,221
6099000911,"Census Tract 9.11, Stanislaus County, California",1785,68,1131,73,654,83
6099000912,"Census Tract 9.12, Stanislaus County, California",4417,170,3422,224,995,254
6099001001,"Census Tract 10.01, Stanislaus County, California",2462,155,1391,186,1071,197
6099001002,"Census Tract 10.02, Stanislaus County, California",1352,90,600,99,752,113
6099001100,"Census Tract 11, Stanislaus County, California",1348,125,486,104,862,149
6099001200,"Census Tract 12, Stanislaus County, California",1667,87,655,107,1012,138
6099001300,"Census Tract 13, Stanislaus County, California",2454,112,1904,161,550,152
6099001400,"Census Tract 14, Stanislaus County, California",2408,113,1234,145,1174,152
6099001500,"Census Tract 15, Stanislaus County, California",1980,134,1209,158,771,159
6099001601,"Census Tract 16.01, Stanislaus County, California",1104,98,683,123,421,130
6099001603,"Census Tract 16.03, Stanislaus County, California",1522,99,904,120,618,128
6099001604,"Census Tract 16.04, Stanislaus County, California",944,72,341,81,603,90
6099001700,"Census Tract 17, Stanislaus County, California",725,81,352,77,373,89
6099001800,"Census Tract 18, Stanislaus County, California",920,85,166,69,754,93
6099001900,"Census Tract 19, Stanislaus County, California",2097,129,1448,196,649,175
6099002002,"Census Tract 20.02, Stanislaus County, California",1228,97,723,104,505,113
6099002003,"Census Tract 20.03, Stanislaus County, California",2459,78,1538,200,921,203
6099002004,"Census Tract 20.04, Stanislaus County, California",1887,167,1150,175,737,182
6099002100,"Census Tract 21, Stanislaus County, California",1097,115,296,95,801,131
6099002200,"Census Tract 22, Stanislaus County, California",1646,118,649,125,997,153
6099002301,"Census Tract 23.01, Stanislaus County, California",1822,137,852,134,970,180
6099002302,"Census Tract 23.02, Stanislaus County, California",1125,73,562,115,563,115
6099002400,"Census Tract 24, Stanislaus County, California",2152,136,1130,187,1022,197
6099002501,"Census Tract 25.01, Stanislaus County, California",1404,85,1084,108,320,112
6099002502,"Census Tract 25.02, Stanislaus County, California",2360,160,1479,210,881,215
6099002602,"Census Tract 26.02, Stanislaus County, California",1469,102,664,89,805,128
6099002603,"Census Tract 26.03, Stanislaus County, California",938,84,704,83,234,98
6099002604,"Census Tract 26.04, Stanislaus County, California",1214,117,302,98,912,150
6099002605,"Census Tract 26.05, Stanislaus County, California",1198,69,946,98,252,94
6099002701,"Census Tract 27.01, Stanislaus County, California",1184,71,1073,85,111,60
6099002702,"Census Tract 27.02, Stanislaus County, California",1769,126,998,132,771,138
6099002801,"Census Tract 28.01, Stanislaus County, California",1572,118,1154,137,418,104
6099002802,"Census Tract 28.02, Stanislaus County, California",2023,145,1432,169,591,150
6099002803,"Census Tract 28.03, Stanislaus County, California",1113,50,972,91,141,69
6099002901,"Census Tract 29.01, Stanislaus County, California",1519,95,1106,95,413,94
6099002902,"Census Tract 29.02, Stanislaus County, California",2004,221,1298,265,706,174
6099003001,"Census Tract 30.01, Stanislaus County, California",2064,103,1752,149,312,115
6099003002,"Census Tract 30.02, Stanislaus County, California",1904,134,1378,157,526,132
6099003100,"Census Tract 31, Stanislaus County, California",1237,103,666,112,571,119
6099003201,"Census Tract 32.01, Stanislaus County, California",1545,171,1031,164,514,181
6099003202,"Census Tract 32.02, Stanislaus County, California",3854,242,2919,267,935,234
6099003300,"Census Tract 33, Stanislaus County, California",1361,150,840,141,521,143
6099003400,"Census Tract 34, Stanislaus County, California",601,81,322,78,279,82
6099003500,"Census Tract 35, Stanislaus County, California",3045,194,2296,215,749,187
6099003602,"Census Tract 36.02, Stanislaus County, California",5524,226,3507,216,2017,211
6099003603,"Census Tract 36.03, Stanislaus County, California",1293,126,690,90,603,142
6099003604,"Census Tract 36.04, Stanislaus County, California",2335,153,1834,193,501,166
6099003700,"Census Tract 37, Stanislaus County, California",1363,77,852,135,511,134
6099003801,"Census Tract 38.01, Stanislaus County, California",2898,157,1258,223,1640,201
6099003802,"Census Tract 38.02, Stanislaus County, California",1558,113,569,131,989,157
6099003803,"Census Tract 38.03, Stanislaus County, California",808,52,452,97,356,109
6099003904,"Census Tract 39.04, Stanislaus County, California",1730,116,876,128,854,136
6099003905,"Census Tract 39.05, Stanislaus County, California",1425,70,1271,94,154,66
6099003906,"Census Tract 39.06, Stanislaus County, California",1716,112,220,81,1496,132
6099003907,"Census Tract 39.07, Stanislaus County, California",2726,155,1864,194,862,209
6099003908,"Census Tract 39.08, Stanislaus County, California",992,76,322,73,670,105
6099003909,"Census Tract 39.09, Stanislaus County, California",2078,122,1303,176,775,188
6101050101,"Census Tract 501.01, Sutter County, California",2290,156,1204,206,1086,194
6101050102,"Census Tract 501.02, Sutter County, California",1637,152,610,121,1027,161
6101050201,"Census Tract 502.01, Sutter County, California",1163,109,398,84,765,101
6101050202,"Census Tract 502.02, Sutter County, California",1463,118,330,104,1133,150
6101050301,"Census Tract 503.01, Sutter County, California",1041,66,566,85,475,91
6101050302,"Census Tract 503.02, Sutter County, California",1771,143,815,133,956,140
6101050400,"Census Tract 504, Sutter County, California",3786,162,3004,207,782,174
6101050501,"Census Tract 505.01, Sutter County, California",1729,116,840,111,889,119
6101050503,"Census Tract 505.03, Sutter County, California",1858,109,1431,140,427,119
6101050504,"Census Tract 505.04, Sutter County, California",2203,113,1929,131,274,118
6101050601,"Census Tract 506.01, Sutter County, California",1878,91,1547,104,331,75
6101050603,"Census Tract 506.03, Sutter County, California",1711,117,1453,124,258,84
6101050604,"Census Tract 506.04, Sutter County, California",1712,88,932,112,780,127
6101050700,"Census Tract 507, Sutter County, California",2872,259,1794,245,1078,223
6101050800,"Census Tract 508, Sutter County, California",1337,92,1078,107,259,87
6101050900,"Census Tract 509, Sutter County, California",571,62,407,68,164,61
6101051000,"Census Tract 510, Sutter County, California",771,81,518,90,253,84
6101051100,"Census Tract 511, Sutter County, California",954,77,676,73,278,58
6103000100,"Census Tract 1, Tehama County, California",1870,119,1301,103,569,123
6103000200,"Census Tract 2, Tehama County, California",2723,164,1992,184,731,158
6103000300,"Census Tract 3, Tehama County, California",1408,157,1089,135,319,106
6103000400,"Census Tract 4, Tehama County, California",2038,122,1853,126,185,74
6103000500,"Census Tract 5, Tehama County, California",2183,243,858,172,1325,231
6103000600,"Census Tract 6, Tehama County, California",2575,146,1548,196,1027,220
6103000700,"Census Tract 7, Tehama County, California",2623,292,1204,200,1419,222
6103000800,"Census Tract 8, Tehama County, California",1315,143,959,167,356,113
6103000900,"Census Tract 9, Tehama County, California",1438,117,812,138,626,146
6103001000,"Census Tract 10, Tehama County, California",2417,161,1849,189,568,169
6103001100,"Census Tract 11, Tehama County, California",2701,232,1515,230,1186,209
6105000100,"Census Tract 1, Trinity County, California",3362,350,2547,275,815,190
6105000200,"Census Tract 2, Trinity County, California",826,142,640,111,186,74
6105000300,"Census Tract 3, Trinity County, California",1236,157,960,163,276,115
6105000400,"Census Tract 4, Trinity County, California",335,70,262,56,73,35
6107000100,"Census Tract 1, Tulare County, California",1905,171,1384,148,521,148
6107000201,"Census Tract 2.01, Tulare County, California",1904,130,1021,121,883,161
6107000202,"Census Tract 2.02, Tulare County, California",634,79,223,61,411,91
6107000301,"Census Tract 3.01, Tulare County, California",1661,98,1047,94,614,101
6107000302,"Census Tract 3.02, Tulare County, California",784,49,407,58,377,62
6107000401,"Census Tract 4.01, Tulare County, California",1242,88,797,125,445,127
6107000402,"Census Tract 4.02, Tulare County, California",1951,125,1406,131,545,109
6107000501,"Census Tract 5.01, Tulare County, California",1670,116,622,134,1048,163
6107000502,"Census Tract 5.02, Tulare County, California",684,70,441,85,243,97
6107000600,"Census Tract 6, Tulare County, California",1366,83,686,117,680,108
6107000701,"Census Tract 7.01, Tulare County, California",744,66,424,91,320,95
6107000702,"Census Tract 7.02, Tulare County, California",1490,115,772,133,718,122
6107000800,"Census Tract 8, Tulare County, California",1970,176,1258,192,712,168
6107000900,"Census Tract 9, Tulare County, California",1725,113,1042,140,683,156
6107001003,"Census Tract 10.03, Tulare County, California",4613,219,3683,267,930,257
6107001004,"Census Tract 10.04, Tulare County, California",1995,84,1066,143,929,149
6107001005,"Census Tract 10.05, Tulare County, California",886,81,781,91,105,63
6107001006,"Census Tract 10.06, Tulare County, California",2125,110,1215,124,910,156
6107001100,"Census Tract 11, Tulare County, California",1972,146,590,122,1382,141
6107001200,"Census Tract 12, Tulare County, California",499,82,127,50,372,94
6107001301,"Census Tract 13.01, Tulare County, California",2464,150,1751,198,713,192
6107001302,"Census Tract 13.02, Tulare County, California",2132,195,1091,165,1041,207
6107001400,"Census Tract 14, Tulare County, California",1584,93,998,96,586,114
6107001501,"Census Tract 15.01, Tulare County, California",1663,111,1078,126,585,115
6107001502,"Census Tract 15.02, Tulare County, California",1683,117,999,129,684,135
6107001601,"Census Tract 16.01, Tulare County, California",1313,121,663,97,650,96
6107001602,"Census Tract 16.02, Tulare County, California",1625,107,891,116,734,137
6107001701,"Census Tract 17.01, Tulare County, California",2375,133,770,180,1605,216
6107001703,"Census Tract 17.03, Tulare County, California",2447,130,1867,174,580,185
6107001704,"Census Tract 17.04, Tulare County, California",1864,142,1240,153,624,138
6107001800,"Census Tract 18, Tulare County, California",1741,148,1123,128,618,138
6107001901,"Census Tract 19.01, Tulare County, California",1259,53,1088,90,171,76
6107001902,"Census Tract 19.02, Tulare County, California",1482,74,1202,99,280,100
6107002002,"Census Tract 20.02, Tulare County, California",1667,91,1114,121,553,119
6107002003,"Census Tract 20.03, Tulare County, California",2059,168,1157,112,902,174
6107002004,"Census Tract 20.04, Tulare County, California",1776,103,1006,130,770,105
6107002006,"Census Tract 20.06, Tulare County, California",1544,89,1203,106,341,91
6107002007,"Census Tract 20.07, Tulare County, California",2353,107,1618,160,735,155
6107002008,"Census Tract 20.08, Tulare County, California",1039,90,293,78,746,112
6107002009,"Census Tract 20.09, Tulare County, California",1590,116,1017,113,573,140
6107002100,"Census Tract 21, Tulare County, California",606,65,356,44,250,51
6107002201,"Census Tract 22.01, Tulare County, California",2815,135,1838,190,977,168
6107002202,"Census Tract 22.02, Tulare County, California",1277,114,514,120,763,124
6107002302,"Census Tract 23.02, Tulare County, California",1562,66,969,103,593,101
6107002303,"Census Tract 23.03, Tulare County, California",2210,115,1673,184,537,170
6107002304,"Census Tract 23.04, Tulare County, California",803,52,410,95,393,122
6107002400,"Census Tract 24, Tulare County, California",2521,142,1768,146,753,101
6107002500,"Census Tract 25, Tulare County, California",1039,83,791,107,248,91
6107002601,"Census Tract 26.01, Tulare County, California",1117,106,586,89,531,97
6107002602,"Census Tract 26.02, Tulare County, California",1277,102,850,127,427,130
6107002700,"Census Tract 27, Tulare County, California",2195,181,1608,190,587,154
6107002800,"Census Tract 28, Tulare County, California",834,74,338,69,496,80
6107002901,"Census Tract 29.01, Tulare County, California",1091,110,349,77,742,115
6107002903,"Census Tract 29.03, Tulare County, California",1615,83,1133,128,482,143
6107002904,"Census Tract 29.04, Tulare County, California",1450,79,727,96,723,113
6107003001,"Census Tract 30.01, Tulare County, California",1145,90,622,87,523,111
6107003002,"Census Tract 30.02, Tulare County, California",958,57,468,88,490,85
6107003100,"Census Tract 31, Tulare County, California",1060,71,395,54,665,70
6107003200,"Census Tract 32, Tulare County, California",1442,74,598,66,844,78
6107003300,"Census Tract 33, Tulare County, California",2018,139,1163,148,855,149
6107003400,"Census Tract 34, Tulare County, California",1745,83,1153,106,592,104
6107003500,"Census Tract 35, Tulare County, California",3836,190,3106,252,730,177
6107003601,"Census Tract 36.01, Tulare County, California",2193,138,1386,165,807,163
6107003602,"Census Tract 36.02, Tulare County, California",2154,120,1310,137,844,152
6107003700,"Census Tract 37, Tulare County, California",1758,153,799,125,959,162
6107003801,"Census Tract 38.01, Tulare County, California",1086,94,491,101,595,115
6107003802,"Census Tract 38.02, Tulare County, California",1434,108,421,110,1013,137
6107003901,"Census Tract 39.01, Tulare County, California",1978,63,1329,142,649,128
6107003902,"Census Tract 39.02, Tulare County, California",1486,96,850,79,636,103
6107004000,"Census Tract 40, Tulare County, California",0,132,0,132,0,132
6107004101,"Census Tract 41.01, Tulare County, California",2423,159,933,191,1490,197
6107004102,"Census Tract 41.02, Tulare County, California",617,53,347,84,270,68
6107004200,"Census Tract 42, Tulare County, California",1357,93,721,118,636,107
6107004300,"Census Tract 43, Tulare County, California",1625,68,812,91,813,96
6107004400,"Census Tract 44, Tulare County, California",1426,93,620,123,806,113
6107004500,"Census Tract 45, Tulare County, California",1547,98,954,114,593,116
6109001100,"Census Tract 11, Tuolumne County, California",1618,149,932,120,686,134
6109001200,"Census Tract 12, Tuolumne County, California",1894,141,659,117,1235,156
6109002100,"Census Tract 21, Tuolumne County, California",2061,163,1338,177,723,172
6109002200,"Census Tract 22, Tuolumne County, California",3119,183,2650,163,469,138
6109003100,"Census Tract 31, Tuolumne County, California",2822,332,2119,275,703,240
6109003200,"Census Tract 32, Tuolumne County, California",2321,205,1589,203,732,195
6109004100,"Census Tract 41, Tuolumne County, California",2367,136,1631,164,736,164
6109004200,"Census Tract 42, Tuolumne County, California",1721,208,1445,204,276,119
6109005100,"Census Tract 51, Tuolumne County, California",3538,247,2510,255,1028,217
6109005201,"Census Tract 52.01, Tuolumne County, California",656,73,605,72,51,27
6109005202,"Census Tract 52.02, Tuolumne County, California",0,132,0,132,0,132
6111000100,"Census Tract 1, Ventura County, California",353,71,303,76,50,37
6111000200,"Census Tract 2, Ventura County, California",624,70,233,81,391,80
6111000301,"Census Tract 3.01, Ventura County, California",2614,161,1928,199,686,158
6111000302,"Census Tract 3.02, Ventura County, California",2231,171,1406,220,825,206
6111000400,"Census Tract 4, Ventura County, California",1762,109,1174,169,588,140
6111000500,"Census Tract 5, Ventura County, California",564,59,324,67,240,66
6111000600,"Census Tract 6, Ventura County, California",1734,112,338,96,1396,132
6111000700,"Census Tract 7, Ventura County, California",2513,131,1491,186,1022,175
6111000800,"Census Tract 8, Ventura County, California",2457,152,1667,167,790,170
6111000901,"Census Tract 9.01, Ventura County, California",1045,111,672,121,373,95
6111000902,"Census Tract 9.02, Ventura County, California",770,97,450,63,320,88
6111000903,"Census Tract 9.03, Ventura County, California",2296,173,1462,192,834,172
6111001001,"Census Tract 10.01, Ventura County, California",881,96,685,104,196,84
6111001002,"Census Tract 10.02, Ventura County, California",2614,125,1939,180,675,173
6111001101,"Census Tract 11.01, Ventura County, California",1770,57,1373,115,397,125
6111001102,"Census Tract 11.02, Ventura County, California",1258,90,950,100,308,100
6111001201,"Census Tract 12.01, Ventura County, California",1657,68,1000,96,657,91
6111001202,"Census Tract 12.02, Ventura County, California",2336,81,2140,121,196,105
6111001204,"Census Tract 12.04, Ventura County, California",665,80,478,69,187,72
6111001205,"Census Tract 12.05, Ventura County, California",280,61,225,58,55,25
6111001301,"Census Tract 13.01, Ventura County, California",2440,98,1403,152,1037,170
6111001302,"Census Tract 13.02, Ventura County, California",587,78,453,72,134,67
6111001401,"Census Tract 14.01, Ventura County, California",1189,59,963,104,226,86
6111001402,"Census Tract 14.02, Ventura County, California",2150,56,1292,114,858,113
6111001502,"Census Tract 15.02, Ventura County, California",3250,121,1652,189,1598,181
6111001503,"Census Tract 15.03, Ventura County, California",1793,76,664,90,1129,95
6111001506,"Census Tract 15.06, Ventura County, California",1577,111,1248,133,329,116
6111001507,"Census Tract 15.07, Ventura County, California",1267,103,767,119,500,118
6111001601,"Census Tract 16.01, Ventura County, California",442,52,93,45,349,73
6111001602,"Census Tract 16.02, Ventura County, California",870,89,776,93,94,54
6111001700,"Census Tract 17, Ventura County, California",1290,57,1099,72,191,74
6111001800,"Census Tract 18, Ventura County, California",1568,65,1339,97,229,66
6111001900,"Census Tract 19, Ventura County, California",1589,80,926,128,663,127
6111002000,"Census Tract 20, Ventura County, California",1087,71,780,69,307,75
6111002102,"Census Tract 21.02, Ventura County, California",987,65,276,82,711,91
6111002200,"Census Tract 22, Ventura County, California",2024,156,931,137,1093,186
6111002300,"Census Tract 23, Ventura County, California",2027,89,668,116,1359,142
6111002400,"Census Tract 24, Ventura County, California",1330,82,132,59,1198,95
6111002500,"Census Tract 25, Ventura County, California",2292,181,1217,138,1075,177
6111002600,"Census Tract 26, Ventura County, California",1284,83,461,103,823,108
6111002700,"Census Tract 27, Ventura County, California",1561,111,699,121,862,120
6111002800,"Census Tract 28, Ventura County, California",2437,108,1282,138,1155,153
6111002901,"Census Tract 29.01, Ventura County, California",1757,61,1503,90,254,80
6111002902,"Census Tract 29.02, Ventura County, California",1690,108,1208,142,482,118
6111003001,"Census Tract 30.01, Ventura County, California",1767,112,766,95,1001,148
6111003002,"Census Tract 30.02, Ventura County, California",2507,126,1207,167,1300,195
6111003100,"Census Tract 31, Ventura County, California",3599,103,2901,242,698,216
6111003201,"Census Tract 32.01, Ventura County, California",917,58,292,87,625,100
6111003202,"Census Tract 32.02, Ventura County, California",775,27,108,59,667,63
6111003300,"Census Tract 33, Ventura County, California",2210,128,1265,194,945,208
6111003401,"Census Tract 34.01, Ventura County, California",1626,53,783,123,843,122
6111003402,"Census Tract 34.02, Ventura County, California",2010,109,497,86,1513,137
6111003500,"Census Tract 35, Ventura County, California",383,57,157,48,226,79
6111003603,"Census Tract 36.03, Ventura County, California",2682,251,1792,215,890,211
6111003604,"Census Tract 36.04, Ventura County, California",2053,192,840,133,1213,222
6111003605,"Census Tract 36.05, Ventura County, California",2759,138,1705,222,1054,213
6111003607,"Census Tract 36.07, Ventura County, California",1326,95,1134,117,192,101
6111003608,"Census Tract 36.08, Ventura County, California",1053,55,651,97,402,85
6111003700,"Census Tract 37, Ventura County, California",1300,91,1017,120,283,125
6111003800,"Census Tract 38, Ventura County, California",1586,121,734,132,852,140
6111003900,"Census Tract 39, Ventura County, California",1633,88,835,152,798,147
6111004000,"Census Tract 40, Ventura County, California",1393,82,975,129,418,115
6111004101,"Census Tract 41.01, Ventura County, California",1311,58,765,116,546,111
6111004102,"Census Tract 41.02, Ventura County, California",571,22,466,85,105,78
6111004200,"Census Tract 42, Ventura County, California",1441,90,1241,91,200,90
6111004301,"Census Tract 43.01, Ventura County, California",647,87,44,32,603,91
6111004302,"Census Tract 43.02, Ventura County, California",2469,212,1533,201,936,177
6111004400,"Census Tract 44, Ventura County, California",2668,203,1134,210,1534,238
6111004501,"Census Tract 45.01, Ventura County, California",1854,90,445,87,1409,124
6111004503,"Census Tract 45.03, Ventura County, California",920,89,438,110,482,122
6111004504,"Census Tract 45.04, Ventura County, California",1194,54,597,116,597,114
6111004600,"Census Tract 46, Ventura County, California",615,74,0,132,615,74
6111004702,"Census Tract 47.02, Ventura County, California",1257,64,935,132,322,127
6111004703,"Census Tract 47.03, Ventura County, California",2151,103,1221,163,930,166
6111004704,"Census Tract 47.04, Ventura County, California",443,53,294,65,149,68
6111004705,"Census Tract 47.05, Ventura County, California",1641,76,1129,100,512,112
6111004706,"Census Tract 47.06, Ventura County, California",372,96,207,80,165,81
6111004900,"Census Tract 49, Ventura County, California",2820,125,1312,224,1508,234
6111005001,"Census Tract 50.01, Ventura County, California",2422,131,1479,226,943,187
6111005002,"Census Tract 50.02, Ventura County, California",688,42,223,60,465,57
6111005100,"Census Tract 51, Ventura County, California",982,90,783,93,199,67
6111005201,"Census Tract 52.01, Ventura County, California",3426,109,2843,176,583,154
6111005202,"Census Tract 52.02, Ventura County, California",969,69,764,75,205,63
6111005203,"Census Tract 52.03, Ventura County, California",1898,89,1528,116,370,111
6111005303,"Census Tract 53.03, Ventura County, California",3074,111,2617,144,457,120
6111005304,"Census Tract 53.04, Ventura County, California",2707,172,2095,188,612,146
6111005305,"Census Tract 53.05, Ventura County, California",2124,101,1672,89,452,87
6111005306,"Census Tract 53.06, Ventura County, California",1672,55,1396,111,276,103
6111005401,"Census Tract 54.01, Ventura County, California",1297,47,1036,86,261,82
6111005403,"Census Tract 54.03, Ventura County, California",976,64,370,74,606,91
6111005404,"Census Tract 54.04, Ventura County, California",1229,44,1141,78,88,62
6111005502,"Census Tract 55.02, Ventura County, California",2022,103,530,99,1492,138
6111005503,"Census Tract 55.03, Ventura County, California",1098,94,677,84,421,104
6111005504,"Census Tract 55.04, Ventura County, California",1494,71,1069,90,425,89
6111005600,"Census Tract 56, Ventura County, California",3079,138,2232,192,847,159
6111005700,"Census Tract 57, Ventura County, California",451,59,149,55,302,58
6111005800,"Census Tract 58, Ventura County, California",4416,92,4025,192,391,160
6111005901,"Census Tract 59.01, Ventura County, California",2196,57,2047,96,149,100
6111005906,"Census Tract 59.06, Ventura County, California",2368,91,1514,105,854,120
6111005907,"Census Tract 59.07, Ventura County, California",1645,84,1208,134,437,121
6111005908,"Census Tract 59.08, Ventura County, California",855,56,777,80,78,52
6111005909,"Census Tract 59.09, Ventura County, California",1353,84,1110,117,243,104
6111005910,"Census Tract 59.10, Ventura County, California",609,19,546,48,63,48
6111005911,"Census Tract 59.11, Ventura County, California",1504,62,1089,107,415,107
6111006000,"Census Tract 60, Ventura County, California",1461,35,1281,96,180,91
6111006100,"Census Tract 61, Ventura County, California",2525,136,1092,134,1433,197
6111006200,"Census Tract 62, Ventura County, California",1033,32,999,46,34,37
6111006301,"Census Tract 63.01, Ventura County, California",2349,74,1789,150,560,139
6111006302,"Census Tract 63.02, Ventura County, California",791,44,589,64,202,60
6111006400,"Census Tract 64, Ventura County, California",2323,93,2085,134,238,108
6111006500,"Census Tract 65, Ventura County, California",1012,39,703,96,309,87
6111006600,"Census Tract 66, Ventura County, California",1313,37,1252,52,61,45
6111006700,"Census Tract 67, Ventura County, California",1087,55,786,105,301,100
6111006800,"Census Tract 68, Ventura County, California",1169,42,917,60,252,64
6111006900,"Census Tract 69, Ventura County, California",1455,118,667,102,788,118
6111007000,"Census Tract 70, Ventura County, California",1455,83,435,104,1020,137
6111007100,"Census Tract 71, Ventura County, California",2295,144,975,198,1320,221
6111007201,"Census Tract 72.01, Ventura County, California",1139,28,1074,49,65,41
6111007202,"Census Tract 72.02, Ventura County, California",1593,57,1425,86,168,65
6111007300,"Census Tract 73, Ventura County, California",620,102,502,85,118,64
6111007402,"Census Tract 74.02, Ventura County, California",2452,77,2283,137,169,106
6111007403,"Census Tract 74.03, Ventura County, California",2053,94,1735,141,318,150
6111007404,"Census Tract 74.04, Ventura County, California",3090,109,2460,172,630,140
6111007501,"Census Tract 75.01, Ventura County, California",3454,113,2852,141,602,140
6111007503,"Census Tract 75.03, Ventura County, California",2164,114,1835,129,329,108
6111007504,"Census Tract 75.04, Ventura County, California",3285,97,1614,162,1671,153
6111007505,"Census Tract 75.05, Ventura County, California",1048,45,952,69,96,59
6111007506,"Census Tract 75.06, Ventura County, California",2259,81,2108,100,151,77
6111007507,"Census Tract 75.07, Ventura County, California",2325,67,2212,89,113,68
6111007508,"Census Tract 75.08, Ventura County, California",1329,85,1033,95,296,78
6111007602,"Census Tract 76.02, Ventura County, California",2426,116,1231,159,1195,179
6111007604,"Census Tract 76.04, Ventura County, California",3486,164,3179,213,307,136
6111007606,"Census Tract 76.06, Ventura County, California",145,46,126,49,19,21
6111007607,"Census Tract 76.07, Ventura County, California",2269,103,2136,124,133,83
6111007608,"Census Tract 76.08, Ventura County, California",2803,92,2612,154,191,107
6111007700,"Census Tract 77, Ventura County, California",1883,89,1572,132,311,105
6111007800,"Census Tract 78, Ventura County, California",1337,60,450,106,887,106
6111007901,"Census Tract 79.01, Ventura County, California",1631,38,1118,114,513,104
6111007903,"Census Tract 79.03, Ventura County, California",1267,46,1115,77,152,69
6111007904,"Census Tract 79.04, Ventura County, California",1666,37,1479,111,187,106
6111008001,"Census Tract 80.01, Ventura County, California",894,59,789,70,105,53
6111008002,"Census Tract 80.02, Ventura County, California",1520,65,1021,106,499,108
6111008004,"Census Tract 80.04, Ventura County, California",1392,80,1099,112,293,102
6111008005,"Census Tract 80.05, Ventura County, California",720,26,631,56,89,55
6111008101,"Census Tract 81.01, Ventura County, California",1074,27,872,102,202,99
6111008201,"Census Tract 82.01, Ventura County, California",1272,63,933,113,339,117
6111008202,"Census Tract 82.02, Ventura County, California",1378,25,1140,78,238,82
6111008302,"Census Tract 83.02, Ventura County, California",1937,46,1470,104,467,108
6111008303,"Census Tract 83.03, Ventura County, California",1253,57,822,95,431,88
6111008304,"Census Tract 83.04, Ventura County, California",1966,77,1642,110,324,102
6111008305,"Census Tract 83.05, Ventura County, California",1178,48,1178,48,0,132
6111008306,"Census Tract 83.06, Ventura County, California",1384,75,658,89,726,96
6111008401,"Census Tract 84.01, Ventura County, California",1738,59,1177,124,561,120
6111008402,"Census Tract 84.02, Ventura County, California",1489,72,1376,103,113,80
6111008500,"Census Tract 85, Ventura County, California",2572,101,2100,137,472,123
6113010101,"Census Tract 101.01, Yolo County, California",2062,190,959,170,1103,190
6113010102,"Census Tract 101.02, Yolo County, California",2520,195,1409,179,1111,251
6113010201,"Census Tract 102.01, Yolo County, California",1174,85,809,100,365,84
6113010203,"Census Tract 102.03, Yolo County, California",2048,168,749,140,1299,180
6113010204,"Census Tract 102.04, Yolo County, California",2115,183,1275,175,840,211
6113010300,"Census Tract 103, Yolo County, California",6534,282,4915,317,1619,290
6113010400,"Census Tract 104, Yolo County, California",489,88,307,70,182,83
6113010501,"Census Tract 105.01, Yolo County, California",1097,159,55,32,1042,159
6113010505,"Census Tract 105.05, Yolo County, California",1598,101,1110,100,488,116
6113010506,"Census Tract 105.06, Yolo County, California",1309,80,866,111,443,105
6113010507,"Census Tract 105.07, Yolo County, California",3382,173,1237,140,2145,192
6113010508,"Census Tract 105.08, Yolo County, California",957,74,554,63,403,88
6113010509,"Census Tract 105.09, Yolo County, California",1292,79,658,77,634,95
6113010510,"Census Tract 105.10, Yolo County, California",2024,112,953,106,1071,140
6113010602,"Census Tract 106.02, Yolo County, California",2297,183,466,103,1831,203
6113010605,"Census Tract 106.05, Yolo County, California",1076,84,679,89,397,89
6113010606,"Census Tract 106.06, Yolo County, California",2561,149,1496,162,1065,184
6113010607,"Census Tract 106.07, Yolo County, California",1437,95,937,97,500,108
6113010608,"Census Tract 106.08, Yolo County, California",1845,149,618,105,1227,159
6113010701,"Census Tract 107.01, Yolo County, California",1887,155,494,86,1393,164
6113010703,"Census Tract 107.03, Yolo County, California",1536,134,514,56,1022,140
6113010704,"Census Tract 107.04, Yolo County, California",910,95,412,63,498,99
6113010800,"Census Tract 108, Yolo County, California",1259,110,701,105,558,116
6113010901,"Census Tract 109.01, Yolo County, California",1759,101,1038,121,721,111
6113010902,"Census Tract 109.02, Yolo County, California",2420,174,746,150,1674,224
6113011001,"Census Tract 110.01, Yolo County, California",2358,166,793,126,1565,214
6113011002,"Census Tract 110.02, Yolo County, California",1394,87,1116,86,278,85
6113011101,"Census Tract 111.01, Yolo County, California",1100,69,727,105,373,117
6113011102,"Census Tract 111.02, Yolo County, California",1557,103,711,150,846,151
6113011103,"Census Tract 111.03, Yolo County, California",1021,76,680,97,341,102
6113011203,"Census Tract 112.03, Yolo County, California",1035,69,956,75,79,44
6113011204,"Census Tract 112.04, Yolo County, California",1703,64,1351,97,352,86
6113011205,"Census Tract 112.05, Yolo County, California",2094,157,1548,159,546,144
6113011206,"Census Tract 112.06, Yolo County, California",1889,189,1405,174,484,126
6113011300,"Census Tract 113, Yolo County, California",2611,237,1597,208,1014,173
6113011400,"Census Tract 114, Yolo County, California",1281,168,726,156,555,138
6113011500,"Census Tract 115, Yolo County, California",1869,215,1327,211,542,165
6115040100,"Census Tract 401, Yuba County, California",1774,170,426,99,1348,151
6115040200,"Census Tract 402, Yuba County, California",2845,236,1525,249,1320,218
6115040300,"Census Tract 403, Yuba County, California",3797,251,1861,258,1936,288
6115040400,"Census Tract 404, Yuba County, California",1743,155,987,169,756,168
6115040500,"Census Tract 405, Yuba County, California",1155,138,527,108,628,149
6115040600,"Census Tract 406, Yuba County, California",1988,128,1226,168,762,166
6115040700,"Census Tract 407, Yuba County, California",2801,246,2273,234,528,201
6115040800,"Census Tract 408, Yuba County, California",1806,135,1159,131,647,124
6115040901,"Census Tract 409.01, Yuba County, California",896,102,629,116,267,95
6115040902,"Census Tract 409.02, Yuba County, California",918,131,0,132,918,131
6115041000,"Census Tract 410, Yuba County, California",2498,155,2228,149,270,106
6115041100,"Census Tract 411, Yuba County, California",1991,139,1402,145,589,153